year,state_name,county_name,fips,year,total_pop,white_pop,non_hispanic_pop,hispanic_pop
2020, Alabama,DeKalb County,01049,2020,71608,56420,59864,11744
2000, Alabama,Shelby County,01117,2000,143293,128671,140383,2910
2010, Alabama,Perry County,01105,2010,10591,3204,10477,114
2020, Alabama,Perry County,01105,2020,8511,2359,8422,89
2000, Alabama,Perry County,01105,2000,11861,3660,11759,102
2010, Alabama,Wilcox County,01131,2010,11670,3126,11598,72
2020, Alabama,Wilcox County,01131,2020,10600,2880,10488,112
2000, Alabama,Wilcox County,01131,2000,13183,3626,13086,97
2010, Alabama,Greene County,01063,2010,9045,1575,8976,69
2000, Alabama,Greene County,01063,2000,9974,1904,9916,58
2000, Alabama,Lowndes County,01085,2000,13473,3484,13388,85
2020, Alabama,Greene County,01063,2020,7730,1301,7669,61
2000, Alabama,Limestone County,01083,2000,65676,55029,63936,1740
2010, Alabama,Limestone County,01083,2010,82782,66506,78191,4591
2010, Alabama,Pickens County,01107,2010,19746,11110,19433,313
2000, Alabama,Pickens County,01107,2000,20949,11720,20802,147
2020, Alabama,Pickens County,01107,2020,19123,10739,18070,1053
2000, Alabama,Hale County,01065,2000,17185,6844,17028,157
2020, Alabama,Hale County,01065,2020,14785,5999,14636,149
2010, Alabama,Hale County,01065,2010,15760,6266,15620,140
2000, Alabama,Blount County,01009,2000,51024,48512,48306,2718
2020, Alabama,Limestone County,01083,2020,103570,77064,96322,7248
2020, Alabama,Blount County,01009,2020,59134,50663,53363,5771
2020, Alabama,Lowndes County,01085,2020,10311,2818,10171,140
2010, Alabama,Shelby County,01117,2010,195085,161943,183518,11567
2000, Alabama,Calhoun County,01015,2000,112249,88537,110496,1753
2010, Alabama,Calhoun County,01015,2010,118572,88840,114679,3893
2020, Alabama,Calhoun County,01015,2020,116441,80586,111431,5010
2020, Alabama,Madison County,01089,2020,388153,242510,363217,24936
2000, Alabama,Madison County,01089,2000,276700,199401,271474,5226
2010, Alabama,Madison County,01089,2010,334811,228280,319407,15404
2010, Alabama,Macon County,01087,2010,21452,3319,21220,232
2020, Alabama,Macon County,01087,2020,19532,3252,19171,361
2000, Alabama,Macon County,01087,2000,24105,3365,23932,173
2010, Alabama,Lowndes County,01085,2010,11299,2859,11212,87
2010, Alabama,Geneva County,01061,2010,26790,23127,25870,920
2010, Alabama,Butler County,01013,2010,20947,11399,20756,191
2020, Alabama,Butler County,01013,2020,19051,9752,18791,260
2000, Alabama,Geneva County,01061,2000,25764,22442,25311,453
2020, Alabama,Geneva County,01061,2020,26659,22078,25363,1296
2020, Alabama,Coosa County,01037,2020,10387,6824,10186,201
2010, Alabama,Bullock County,01011,2010,10914,2507,10137,777
2020, Alabama,Bullock County,01011,2020,10357,2320,9854,503
2000, Alabama,Bullock County,01011,2000,11714,2958,11392,322
2020, Alabama,Shelby County,01117,2020,223024,165206,206564,16460
2000, Alabama,Butler County,01013,2000,21399,12492,21256,143
2010, Alabama,Marengo County,01091,2010,21027,9751,20675,352
2010, Alabama,Blount County,01009,2010,57322,53068,52696,4626
2010, Alabama,Winston County,01133,2010,24484,23409,23845,639
2000, Alabama,Lawrence County,01079,2000,34803,27067,34436,367
2020, Alabama,Lauderdale County,01077,2020,93564,77141,90486,3078
2010, Alabama,Lauderdale County,01077,2010,92709,80112,90627,2082
2000, Alabama,Lauderdale County,01077,2000,87966,77743,87072,894
2010, Alabama,Barbour County,01005,2010,27457,13180,26070,1387
2020, Alabama,Barbour County,01005,2020,25223,11317,23713,1510
2000, Alabama,Barbour County,01005,2000,29038,14887,28560,478
2000, Alabama,Baldwin County,01003,2000,140415,122366,137949,2466
2010, Alabama,Baldwin County,01003,2010,182265,156153,174273,7992
2010, Alabama,Lawrence County,01079,2010,34339,26647,33765,574
2020, Alabama,Baldwin County,01003,2020,231767,189399,219081,12686
2020, Alabama,Houston County,01069,2020,107202,69265,102721,4481
2000, Alabama,Houston County,01069,2000,88787,64886,87665,1122
2010, Alabama,Lamar County,01075,2010,14564,12626,14384,180
2010, Alabama,Autauga County,01001,2010,54571,42855,53261,1310
2000, Alabama,Autauga County,01001,2000,43671,35221,43061,610
2020, Alabama,Autauga County,01001,2020,58805,42160,56688,2117
2000, Alabama,Lamar County,01075,2000,15904,13816,15697,207
2020, Alabama,Lamar County,01075,2020,13972,11962,13764,208
2000, Alabama,Jackson County,01071,2000,53926,49552,53316,610
2010, Alabama,Houston County,01069,2010,101547,71053,98552,2995
2000, Alabama,Winston County,01133,2000,24843,24177,24471,372
2020, Alabama,Lawrence County,01079,2020,33073,24915,32178,895
2010, Alabama,Sumter County,01119,2010,13763,3326,13677,86
2010, Alabama,Pike County,01109,2010,32899,19144,32169,730
2000, Alabama,Pike County,01109,2000,29605,17990,29240,365
2020, Alabama,Pike County,01109,2020,33009,18275,32104,905
2020, Alabama,Winston County,01133,2020,23540,21760,22725,815
2020, Alabama,Bibb County,01007,2020,22293,16555,21553,740
2000, Alabama,Bibb County,01007,2000,20826,15966,20616,210
2010, Alabama,Bibb County,01007,2010,22915,17381,22509,406
2020, Alabama,Tallapoosa County,01123,2020,41311,28477,40167,1144
2010, Alabama,Tallapoosa County,01123,2010,41616,29087,40574,1042
2020, Alabama,Sumter County,01119,2020,12345,2974,12214,131
2000, Alabama,Tallapoosa County,01123,2000,41475,30474,41233,242
2020, Alabama,Talladega County,01121,2020,82149,51214,80370,1779
2010, Alabama,Talladega County,01121,2010,82291,53739,80620,1671
2010, Alabama,Lee County,01081,2010,140247,100006,135676,4571
2000, Alabama,Lee County,01081,2000,115092,85247,113447,1645
2020, Alabama,Lee County,01081,2020,174241,111651,165106,9135
2000, Alabama,Sumter County,01119,2000,14798,3836,14633,165
2000, Alabama,Henry County,01067,2000,16310,10710,16061,249
2010, Alabama,Henry County,01067,2010,17302,11865,16913,389
2020, Alabama,Henry County,01067,2020,17146,11888,16812,334
2000, Alabama,Talladega County,01121,2000,80321,53830,79509,812
2020, Alabama,Jackson County,01071,2020,52579,45480,50898,1681
2020, Alabama,Marengo County,01091,2020,19323,8428,18955,368
2000, Alabama,Franklin County,01059,2000,31223,28001,28907,2316
2010, Alabama,Coffee County,01031,2010,49948,37330,46768,3180
2010, Alabama,Cullman County,01043,2010,80406,76133,76952,3454
2000, Alabama,Cullman County,01043,2000,77483,75011,75795,1688
2020, Alabama,Cullman County,01043,2020,87866,79142,83720,4146
2010, Alabama,Monroe County,01099,2010,23068,12718,22848,220
2000, Alabama,Monroe County,01099,2000,24324,14047,24134,190
2020, Alabama,Monroe County,01099,2020,19772,10391,19565,207
2020, Alabama,Cleburne County,01029,2020,15056,13819,14772,284
2010, Alabama,Cleburne County,01029,2010,14972,14079,14665,307
2020, Alabama,Coffee County,01031,2020,53465,37080,48578,4887
2000, Alabama,Cleburne County,01029,2000,14123,13380,13925,198
2000, Alabama,Mobile County,01097,2000,399843,252199,394956,4887
2010, Alabama,Mobile County,01097,2010,412992,248647,403056,9936
2000, Alabama,Dale County,01045,2000,49129,36541,47487,1642
2020, Alabama,Dale County,01045,2020,49326,33429,46072,3254
2010, Alabama,Dale County,01045,2010,50251,37236,47430,2821
2020, Alabama,Dallas County,01047,2020,38462,10409,38166,296
2000, Alabama,Dallas County,01047,2000,46365,16496,46075,290
2010, Alabama,Dallas County,01047,2010,43820,12769,43511,309
2000, Alabama,Walker County,01127,2000,70713,65163,70106,607
2020, Alabama,Mobile County,01097,2020,414809,229550,401384,13425
2020, Alabama,Walker County,01127,2020,65342,57012,63190,2152
2000, Alabama,Coffee County,01031,2000,43615,33631,42432,1183
2010, Alabama,Colbert County,01033,2010,54428,43789,53335,1093
2000, Alabama,Coosa County,01037,2000,12202,7802,12044,158
2010, Alabama,Montgomery County,01101,2010,229363,90656,221049,8314
2020, Alabama,Montgomery County,01101,2020,228954,75074,218270,10684
2000, Alabama,Montgomery County,01101,2000,223510,109180,220845,2665
2010, Alabama,Conecuh County,01035,2010,13228,6788,13067,161
2000, Alabama,Conecuh County,01035,2000,14089,7806,13987,102
2020, Alabama,Conecuh County,01035,2020,11597,5912,11341,256
2020, Alabama,Covington County,01039,2020,37570,30877,36916,654
2010, Alabama,Covington County,01039,2010,37765,32022,37282,483
2020, Alabama,Colbert County,01033,2020,57227,43631,55495,1732
2000, Alabama,Covington County,01039,2000,37631,32436,37339,292
2000, Alabama,Washington County,01129,2000,18097,11759,17937,160
2010, Alabama,Washington County,01129,2010,17581,11508,17430,151
2000, Alabama,Morgan County,01103,2000,111064,94485,107419,3645
2020, Alabama,Morgan County,01103,2020,123421,89869,111044,12377
2010, Alabama,Morgan County,01103,2010,119490,95404,110334,9156
2000, Alabama,Crenshaw County,01041,2000,13665,10088,13578,87
2020, Alabama,Crenshaw County,01041,2020,13194,9388,13007,187
2010, Alabama,Crenshaw County,01041,2010,13906,10097,13702,204
2000, Alabama,Colbert County,01033,2000,54984,44825,54366,618
2020, Alabama,Washington County,01129,2020,15388,10309,15250,138
2000, Alabama,Marengo County,01091,2000,22539,10657,22320,219
2010, Alabama,Clay County,01027,2010,13932,11380,13533,399
2000, Alabama,Clay County,01027,2000,14254,11776,14001,253
2020, Alabama,Etowah County,01055,2020,103436,78584,98541,4895
2010, Alabama,Etowah County,01055,2010,104430,83823,100983,3447
2000, Alabama,Etowah County,01055,2000,103459,85737,101696,1763
2010, Alabama,Marshall County,01095,2010,93019,81464,81781,11238
2020, Alabama,Marshall County,01095,2020,97612,76926,81954,15658
2000, Alabama,Marshall County,01095,2000,82231,76791,77575,4656
2010, Alabama,Russell County,01113,2010,52947,28449,51001,1946
2000, Alabama,Russell County,01113,2000,49756,28209,49012,744
2020, Alabama,Russell County,01113,2020,59183,27532,55988,3195
2020, Alabama,Escambia County,01053,2020,36757,22202,36006,751
2020, Alabama,Fayette County,01057,2020,16321,13666,15925,396
2010, Alabama,Fayette County,01057,2010,17241,14910,17037,204
2000, Alabama,Tuscaloosa County,01125,2000,164875,112320,162745,2130
2010, Alabama,Tuscaloosa County,01125,2010,194656,129004,188707,5949
2020, Alabama,Tuscaloosa County,01125,2020,227036,136582,214738,12298
2000, Alabama,Marion County,01093,2000,31214,29579,30854,360
2010, Alabama,Marion County,01093,2010,30776,28791,30144,632
2020, Alabama,Marion County,01093,2020,29341,26312,28478,863
2010, Alabama,Franklin County,01059,2010,31704,26320,26994,4710
2020, Alabama,Franklin County,01059,2020,32113,24333,25854,6259
2000, Alabama,Fayette County,01057,2000,18495,16075,18343,152
2020, Alabama,Clay County,01027,2020,14236,11375,13787,449
2010, Alabama,Escambia County,01053,2010,38319,23784,37601,718
2020, Alabama,Elmore County,01051,2020,87977,63139,85184,2793
2010, Alabama,Walker County,01127,2010,67023,61146,65716,1307
2010, Alabama,Clarke County,01025,2010,25833,14070,25562,271
2000, Alabama,Clarke County,01025,2000,27867,15589,27687,180
2020, Alabama,Clarke County,01025,2020,23087,12029,22881,206
2010, Alabama,DeKalb County,01049,2010,71109,60087,61419,9690
2000, Alabama,DeKalb County,01049,2000,64452,59652,60874,3578
2010, Alabama,Choctaw County,01023,2010,13859,7731,13786,73
2020, Alabama,Choctaw County,01023,2020,12665,7074,12552,113
2000, Alabama,Choctaw County,01023,2000,15922,8779,15815,107
2000, Alabama,Escambia County,01053,2000,38440,24754,38061,379
2020, Alabama,Chilton County,01021,2020,45014,35527,40596,4418
2010, Alabama,Chilton County,01021,2010,43643,36713,40223,3420
2000, Alabama,Cherokee County,01019,2000,23988,22268,23784,204
2010, Alabama,Cherokee County,01019,2010,25989,24081,25669,320
2020, Alabama,Cherokee County,01019,2020,24971,22707,24571,400
2020, Alabama,Chambers County,01017,2020,34772,18850,33535,1237
2010, Alabama,Chambers County,01017,2010,34215,20112,33679,536
2000, Alabama,Chambers County,01017,2000,36583,22271,36303,280
2010, Alabama,Elmore County,01051,2010,79303,60455,77174,2129
2000, Alabama,Elmore County,01051,2000,65874,50737,65069,805
2000, Alabama,Chilton County,01021,2000,39593,34330,38441,1152
2010, Alabama,Jackson County,01071,2010,53227,48348,51888,1339
2010, Alabama,Coosa County,01037,2010,11539,7648,11309,230
2000, Alabama,Jefferson County,01073,2000,662047,384639,651763,10284
2010, Alabama,Jefferson County,01073,2010,658466,349166,632978,25488
2010, Alabama,St. Clair County,01115,2010,83593,73741,81877,1716
2000, Alabama,St. Clair County,01115,2000,64742,58288,64056,686
2020, Alabama,Randolph County,01111,2020,21967,16772,21362,605
2020, Alabama,Jefferson County,01073,2020,674721,329590,639865,34856
2010, Alabama,Randolph County,01111,2010,22913,17532,22264,649
2000, Alabama,Randolph County,01111,2000,22380,17094,22108,272
2020, Alabama,St. Clair County,01115,2020,91103,75728,88528,2575
2000, Alaska,Aleutians West Census Area,02016,2000,5465,2188,4892,573
2010, Alaska,Aleutians East Borough,02013,2010,3141,660,2756,385
2020, Alaska,Aleutians West Census Area,02016,2020,5232,1667,4564,668
2020, Alaska,Lake and Peninsula Borough,02164,2020,1476,303,1442,34
2010, Alaska,Lake and Peninsula Borough,02164,2010,1631,380,1588,43
2020, Alaska,Bristol Bay Borough,02060,2020,844,370,799,45
2000, Alaska,Bristol Bay Borough,02060,2000,1258,661,1251,7
2010, Alaska,Bristol Bay Borough,02060,2010,997,481,973,24
2000, Alaska,Bethel Census Area,02050,2000,16006,2006,15866,140
2000, Alaska,Wade Hampton Census Area,02270,2000,7028,333,7005,23
2010, Alaska,Wade Hampton Census Area,02270,2010,7459,201,7452,7
2000, Alaska,Lake and Peninsula Borough,02164,2000,1823,342,1802,21
2010, Alaska,Bethel Census Area,02050,2010,17013,1894,16832,181
2010, Alaska,Yakutat City and Borough,02282,2010,662,281,645,17
2010, Alaska,Nome Census Area,02180,2010,9492,1552,9377,115
2020, Alaska,Prince of Wales-Hyder Census Area,02198,2020,5753,2403,5593,160
2010, Alaska,Prince of Wales-Hyder Census Area,02198,2010,5559,2799,5432,127
2010, Alaska,Yukon-Koyukuk Census Area,02290,2010,5588,1243,5522,66
2000, Alaska,Yukon-Koyukuk Census Area,02290,2000,6551,1590,6473,78
2010, Alaska,Petersburg Census Area,02195,2010,3815,2711,3685,130
2020, Alaska,Petersburg Borough,02195,2020,3398,2470,3234,164
2000, Alaska,Ketchikan Gateway Borough,02130,2000,14070,10460,13698,372
2000, Alaska,Fairbanks North Star Borough,02090,2000,82840,64439,79400,3440
2020, Alaska,Fairbanks North Star Borough,02090,2020,95655,65971,88335,7320
2010, Alaska,Anchorage Municipality,02020,2010,291826,192498,269765,22061
2020, Alaska,Yakutat City and Borough,02282,2020,662,249,633,29
2000, Alaska,Yakutat City and Borough,02282,2000,808,407,802,6
2010, Alaska,Fairbanks North Star Borough,02090,2010,97581,75175,91930,5651
2020, Alaska,Yukon-Koyukuk Census Area,02290,2020,5343,1130,5271,72
2020, Alaska,Dillingham Census Area,02070,2020,4857,799,4711,146
2020, Alaska,Bethel Census Area,02050,2020,18666,1665,18459,207
2000, Alaska,Nome Census Area,02180,2000,9196,1777,9104,92
2020, Alaska,Northwest Arctic Borough,02188,2020,7793,700,7691,102
2020, Alaska,Nome Census Area,02180,2020,10046,1422,9860,186
2000, Alaska,Denali Borough,02068,2000,1893,1623,1846,47
2010, Alaska,Kodiak Island Borough,02150,2010,13592,7522,12596,996
2000, Alaska,Wrangell-Petersburg Census Area,02280,2000,6684,4882,6552,132
2010, Alaska,Denali Borough,02068,2010,1826,1637,1784,42
2020, Alaska,Denali Borough,02068,2020,1619,1382,1587,32
2010, Alaska,Aleutians West Census Area,02016,2010,5561,2004,4835,726
2020, Alaska,Wrangell City and Borough,02275,2020,2127,1352,2051,76
2010, Alaska,Kenai Peninsula Borough,02122,2010,55400,46857,53759,1641
2010, Alaska,Sitka City and Borough,02220,2010,8881,5798,8444,437
2000, Alaska,Sitka City and Borough,02220,2000,8835,6052,8545,290
2020, Alaska,Chugach Census Area,02063,2020,7102,4907,6705,397
2010, Alaska,Valdez-Cordova Census Area,02261,2010,9636,7127,9287,349
2020, Alaska,Southeast Fairbanks Census Area,02240,2020,6808,5085,6432,376
2020, Alaska,Kenai Peninsula Borough,02122,2020,58799,46382,56471,2328
2000, Alaska,Valdez-Cordova Census Area,02261,2000,10195,7738,9909,286
2010, Alaska,Wrangell City and Borough,02275,2010,2369,1719,2332,37
2000, Alaska,Kodiak Island Borough,02150,2000,13913,8304,13065,848
2020, Alaska,Ketchikan Gateway Borough,02130,2020,13948,8430,13298,650
2000, Alaska,Matanuska-Susitna Borough,02170,2000,59322,51938,57837,1485
2000, Alaska,Prince of Wales-Outer Ketchikan Census Area,02201,2000,6146,3265,6039,107
2010, Alaska,Northwest Arctic Borough,02188,2010,7523,846,7465,58
2020, Alaska,Hoonah-Angoon Census Area,02105,2020,2365,1147,2245,120
2010, Alaska,Hoonah-Angoon Census Area,02105,2010,2150,1014,2073,77
2000, Alaska,Skagway-Hoonah-Angoon Census Area,02232,2000,3436,1998,3339,97
2000, Alaska,Northwest Arctic Borough,02188,2000,7208,888,7151,57
2020, Alaska,Skagway Municipality,02230,2020,1240,1070,1199,41
2010, Alaska,Matanuska-Susitna Borough,02170,2010,88995,75540,85694,3301
2020, Alaska,Matanuska-Susitna Borough,02170,2020,107081,83035,101837,5244
2010, Alaska,Skagway Municipality,02230,2010,968,885,947,21
2020, Alaska,Sitka City and Borough,02220,2020,8458,5174,7957,501
2000, Alaska,Southeast Fairbanks Census Area,02240,2000,6174,4877,6007,167
2010, Alaska,Southeast Fairbanks Census Area,02240,2010,7029,5651,6795,234
2010, Alaska,Ketchikan Gateway Borough,02130,2010,13477,9176,12939,538
2020, Alaska,Kodiak Island Borough,02150,2020,13101,6570,12077,1024
2010, Alaska,Dillingham Census Area,02070,2010,4847,878,4746,101
2000, Alaska,Kenai Peninsula Borough,02122,2000,49691,42841,48604,1087
2000, Alaska,Anchorage Municipality,02020,2000,260283,188009,245484,14799
2000, Alaska,Juneau City and Borough,02110,2000,30711,22969,29671,1040
2020, Alaska,North Slope Borough,02185,2020,11031,3082,10483,548
2020, Alaska,Haines Borough,02100,2020,2080,1589,2013,67
2000, Alaska,Haines Borough,02100,2000,2392,1974,2359,33
2020, Alaska,Aleutians East Borough,02013,2020,3420,684,2746,674
2020, Alaska,Kusilvak Census Area,02158,2020,8368,173,8354,14
2010, Alaska,Haines Borough,02100,2010,2508,2086,2461,47
2010, Alaska,North Slope Borough,02185,2010,9430,3147,9181,249
2010, Alaska,Juneau City and Borough,02110,2010,31275,21814,29687,1588
2020, Alaska,Anchorage Municipality,02020,2020,291247,164446,264809,26438
2000, Alaska,North Slope Borough,02185,2000,7385,1262,7210,175
2000, Alaska,Aleutians East Borough,02013,2000,2697,646,2358,339
2000, Alaska,Dillingham Census Area,02070,2000,4922,1065,4811,111
2020, Alaska,Copper River Census Area,02066,2020,2617,1611,2533,84
2020, Alaska,Juneau City and Borough,02110,2020,32255,20124,30178,2077
2010, Arizona,Apache County,04001,2010,71518,16634,67405,4113
2020, Arizona,Mohave County,04015,2020,213267,169732,179141,34126
2010, Arizona,Santa Cruz County,04023,2010,47420,34835,8147,39273
2010, Arizona,Cochise County,04003,2010,131346,103085,88803,42543
2000, Arizona,Cochise County,04003,2000,117755,90269,81621,36134
2020, Arizona,Pima County,04019,2020,1043433,633382,670645,372788
2010, Arizona,Pima County,04019,2010,980263,728751,641461,338802
2020, Arizona,Cochise County,04003,2020,125447,81733,82832,42615
2000, Arizona,Pima County,04019,2000,843746,633387,596168,247578
2020, Arizona,Pinal County,04021,2020,425264,269258,303731,121533
2010, Arizona,Pinal County,04021,2010,375770,272013,268793,106977
2000, Arizona,Pinal County,04021,2000,179727,126559,126056,53671
2020, Arizona,Navajo County,04017,2020,106717,48430,95830,10887
2000, Arizona,Navajo County,04017,2000,97470,44752,89459,8011
2020, Arizona,Yuma County,04027,2020,203881,90318,73878,130003
2000, Arizona,Yavapai County,04025,2000,167517,153933,151141,16376
2020, Arizona,Yavapai County,04025,2020,236209,192507,201819,34390
2020, Arizona,Coconino County,04005,2020,145101,83360,123382,21719
2010, Arizona,La Paz County,04012,2010,20489,14306,15683,4806
2010, Arizona,Coconino County,04005,2010,134421,82967,116255,18166
2000, Arizona,Coconino County,04005,2000,116320,73381,103593,12727
2010, Arizona,Yuma County,04027,2010,195751,137881,78839,116912
2000, Arizona,Yuma County,04027,2000,160026,109269,79254,80772
2020, Arizona,Apache County,04001,2020,66021,14873,62160,3861
2000, Arizona,Apache County,04001,2000,69423,13536,66304,3119
2010, Arizona,Navajo County,04017,2010,107449,52972,95878,11571
2010, Arizona,Yavapai County,04025,2010,211033,188515,182305,28728
2000, Arizona,Santa Cruz County,04023,2000,38381,29168,7376,31005
2020, Arizona,Greenlee County,04011,2020,9563,6584,5187,4376
2010, Arizona,Greenlee County,04011,2010,8437,6514,4397,4040
2000, Arizona,Graham County,04009,2000,33489,22473,24435,9054
2000, Arizona,Greenlee County,04011,2000,8547,6339,4866,3681
2020, Arizona,Gila County,04007,2020,53272,35904,43989,9283
2010, Arizona,Maricopa County,04013,2010,3817117,2786781,2688376,1128741
2020, Arizona,Graham County,04009,2020,38533,25043,27105,11428
2000, Arizona,Mohave County,04015,2000,155032,139616,137850,17182
2010, Arizona,Mohave County,04015,2010,200186,173878,170617,29569
2020, Arizona,Maricopa County,04013,2020,4420568,2645512,3069153,1351415
2000, Arizona,Maricopa County,04013,2000,3072149,2376359,2308808,763341
2010, Arizona,Graham County,04009,2010,37220,26827,25900,11320
2020, Arizona,La Paz County,04012,2020,16557,9772,12360,4197
2000, Arizona,La Paz County,04012,2000,19715,14619,15295,4420
2020, Arizona,Santa Cruz County,04023,2020,47669,15929,8037,39632
2000, Arizona,Gila County,04007,2000,51335,39951,42789,8546
2010, Arizona,Gila County,04007,2010,53597,41162,44009,9588
2020, Arkansas,Hempstead County,05057,2020,20065,11006,17112,2953
2010, Arkansas,Poinsett County,05111,2010,24583,22089,24040,543
2020, Arkansas,Lawrence County,05075,2020,16216,15044,15859,357
2010, Arkansas,Miller County,05091,2010,43462,31134,42424,1038
2010, Arkansas,Lawrence County,05075,2010,17415,16952,17257,158
2000, Arkansas,Lawrence County,05075,2000,17774,17379,17653,121
2020, Arkansas,Grant County,05053,2020,17958,16304,17518,440
2010, Arkansas,Polk County,05113,2010,20662,19144,19472,1190
2000, Arkansas,Hempstead County,05057,2000,23587,14925,21641,1946
2000, Arkansas,Boone County,05009,2000,33948,33132,33588,360
2010, Arkansas,Hempstead County,05057,2010,22609,13431,19896,2713
2020, Arkansas,Boone County,05009,2020,37373,34128,36400,973
2020, Arkansas,Phillips County,05107,2020,16568,5616,16304,264
2020, Arkansas,Ouachita County,05103,2020,22650,12194,22134,516
2000, Arkansas,Lincoln County,05079,2000,14492,9402,14229,263
2020, Arkansas,Polk County,05113,2020,19221,16428,17943,1278
2020, Arkansas,Jefferson County,05069,2020,67260,25478,65772,1488
2020, Arkansas,Lee County,05077,2020,8600,3465,8384,216
2020, Arkansas,Lincoln County,05079,2020,12941,8324,12322,619
2000, Arkansas,Perry County,05105,2000,10209,9762,10089,120
2000, Arkansas,Phillips County,05107,2000,26445,10379,26063,382
2020, Arkansas,Perry County,05105,2020,10019,9165,9733,286
2020, Arkansas,Poinsett County,05111,2020,22965,19391,22136,829
2020, Arkansas,St. Francis County,05123,2020,23090,9551,22404,686
2000, Arkansas,Poinsett County,05111,2000,25614,23304,25248,366
2000, Arkansas,Carroll County,05015,2000,25357,23741,22886,2471
2020, Arkansas,Crittenden County,05035,2020,48163,19276,46735,1428
2000, Arkansas,Crittenden County,05035,2000,50866,25896,50146,720
2010, Arkansas,Crittenden County,05035,2010,50902,23446,49888,1014
2010, Arkansas,Lee County,05077,2010,10424,4381,10256,168
2010, Arkansas,Clay County,05021,2010,16083,15682,15866,217
2000, Arkansas,Grant County,05053,2000,16464,15731,16275,189
2000, Arkansas,Baxter County,05005,2000,38386,37547,38001,385
2010, Arkansas,Boone County,05009,2010,36903,35624,36229,674
2020, Arkansas,Baxter County,05005,2020,41627,38489,40569,1058
2010, Arkansas,Grant County,05053,2010,17853,16940,17461,392
2020, Arkansas,Saline County,05125,2020,123416,98388,114909,8507
2010, Arkansas,Sevier County,05133,2010,17058,11949,11838,5220
2000, Arkansas,Sevier County,05133,2000,15757,12544,12650,3107
2000, Arkansas,Miller County,05091,2000,40443,29935,39802,641
2020, Arkansas,Miller County,05091,2020,42600,28036,41017,1583
2010, Arkansas,Phillips County,05107,2010,21757,7618,21470,287
2000, Arkansas,Clay County,05021,2000,17609,17271,17469,140
2010, Arkansas,Carroll County,05015,2010,27446,24593,23957,3489
2010, Arkansas,Perry County,05105,2010,10445,9939,10198,247
2000, Arkansas,Fulton County,05049,2000,11642,11371,11580,62
2010, Arkansas,Baxter County,05005,2010,41513,40231,40825,688
2020, Arkansas,Clay County,05021,2020,14552,13731,14225,327
2010, Arkansas,Drew County,05043,2010,18509,12739,18055,454
2000, Arkansas,Woodruff County,05147,2000,8741,5932,8672,69
2000, Arkansas,Cleveland County,05025,2000,8571,7267,8432,139
2010, Arkansas,Cleveland County,05025,2010,8689,7452,8544,145
2000, Arkansas,Drew County,05043,2000,18723,13162,18394,329
2000, Arkansas,Calhoun County,05013,2000,5744,4280,5658,86
2020, Arkansas,Calhoun County,05013,2020,4739,3539,4612,127
2010, Arkansas,Calhoun County,05013,2010,5368,4001,5216,152
2020, Arkansas,Little River County,05081,2020,12026,8714,11617,409
2010, Arkansas,St. Francis County,05123,2010,28258,12502,27109,1149
2000, Arkansas,St. Francis County,05123,2000,29329,14184,27898,1431
2000, Arkansas,Dallas County,05039,2000,9210,5246,9033,177
2010, Arkansas,Dallas County,05039,2010,8116,4476,7928,188
2010, Arkansas,Franklin County,05047,2010,18125,17221,17754,371
2020, Arkansas,Franklin County,05047,2020,17097,15367,16606,491
2000, Arkansas,Greene County,05055,2000,37331,36379,36897,434
2000, Arkansas,Franklin County,05047,2000,17771,17091,17461,310
2010, Arkansas,Little River County,05081,2010,13171,9948,12814,357
2010, Arkansas,Mississippi County,05093,2010,46480,28653,44785,1695
2020, Arkansas,Mississippi County,05093,2020,40685,23208,38914,1771
2020, Arkansas,Drew County,05043,2020,17350,11291,16694,656
2010, Arkansas,Scott County,05127,2010,11233,9880,10451,782
2020, Arkansas,Scott County,05127,2020,9836,8210,9088,748
2000, Arkansas,Pike County,05109,2000,11303,10403,10900,403
2010, Arkansas,Pike County,05109,2010,11291,10163,10564,727
2000, Arkansas,Scott County,05127,2000,10996,10285,10368,628
2000, Arkansas,Mississippi County,05093,2000,51979,33499,50810,1169
2010, Arkansas,Bradley County,05011,2010,11508,6934,9992,1516
2000, Arkansas,Bradley County,05011,2000,12600,7983,11560,1040
2020, Arkansas,Cleburne County,05023,2020,24711,22953,24079,632
2000, Arkansas,Cleburne County,05023,2000,24046,23613,23764,282
2010, Arkansas,Cleburne County,05023,2010,25970,25130,25453,517
2020, Arkansas,Bradley County,05011,2020,10545,5890,8970,1575
2020, Arkansas,Cleveland County,05025,2020,7550,6466,7368,182
2000, Arkansas,Little River County,05081,2000,13628,10155,13393,235
2010, Arkansas,Greene County,05055,2010,42090,40578,41189,901
2000, Arkansas,Lee County,05077,2000,12580,5209,12304,276
2010, Arkansas,Ouachita County,05103,2010,26120,14883,25712,408
2020, Arkansas,Greene County,05055,2020,45736,41038,44140,1596
2020, Arkansas,Benton County,05007,2020,284333,201188,233793,50540
2020, Arkansas,Marion County,05089,2020,16826,15569,16447,379
2020, Arkansas,Pike County,05109,2020,10171,8681,9340,831
2010, Arkansas,Lonoke County,05085,2010,68356,61353,66110,2246
2020, Arkansas,Lonoke County,05085,2020,74015,61624,70405,3610
2010, Arkansas,Marion County,05089,2010,16653,16146,16366,287
2000, Arkansas,Benton County,05007,2000,153406,139399,139937,13469
2020, Arkansas,Woodruff County,05147,2020,6269,4255,6173,96
2000, Arkansas,Lonoke County,05085,2000,52828,48089,51906,922
2010, Arkansas,Fulton County,05049,2010,12245,11857,12148,97
2000, Arkansas,Cross County,05037,2000,19526,14606,19345,181
2020, Arkansas,Cross County,05037,2020,16833,12213,16481,352
2010, Arkansas,Cross County,05037,2010,17870,13495,17604,266
2020, Arkansas,Fulton County,05049,2020,12075,11249,11921,154
2010, Arkansas,Woodruff County,05147,2010,7260,5075,7173,87
2010, Arkansas,Benton County,05007,2010,221339,182817,187056,34283
2000, Arkansas,Marion County,05089,2000,16140,15740,16018,122
2020, Arkansas,Van Buren County,05141,2020,15796,14485,15295,501
2020, Arkansas,Clark County,05019,2020,21446,14316,20354,1092
2010, Arkansas,Clark County,05019,2010,22995,16518,22069,926
2000, Arkansas,Clark County,05019,2000,23546,17491,22980,566
2010, Arkansas,Jefferson County,05069,2010,77435,32507,76216,1219
2000, Arkansas,Jefferson County,05069,2000,84278,40840,83468,810
2020, Arkansas,Logan County,05083,2020,21131,18826,20491,640
2010, Arkansas,Logan County,05083,2010,22353,20844,21843,510
2000, Arkansas,Logan County,05083,2000,22486,21690,22213,273
2020, Arkansas,Dallas County,05039,2020,6482,3487,6281,201
2000, Arkansas,Ouachita County,05103,2000,28790,17200,28580,210
2000, Arkansas,Monroe County,05095,2000,10254,6088,10122,132
2010, Arkansas,Monroe County,05095,2010,8149,4584,8017,132
2020, Arkansas,Sevier County,05133,2020,15839,9594,10331,5508
2000, Arkansas,Van Buren County,05141,2000,16192,15673,15977,215
2010, Arkansas,Van Buren County,05141,2010,17295,16598,16820,475
2000, Arkansas,Polk County,05113,2000,20229,19155,19521,708
2020, Arkansas,Monroe County,05095,2020,6799,3568,6613,186
2020, Arkansas,Carroll County,05015,2020,28260,21952,23954,4306
2010, Arkansas,Lincoln County,05079,2010,14134,9407,13682,452
2000, Arkansas,Washington County,05143,2000,157715,138796,144783,12932
2020, Arkansas,Newton County,05101,2020,7225,6689,7143,82
2010, Arkansas,Newton County,05101,2010,8330,8001,8189,141
2000, Arkansas,Sharp County,05135,2000,17119,16630,16952,167
2010, Arkansas,Sebastian County,05131,2010,125744,96344,110299,15445
2010, Arkansas,Sharp County,05135,2010,17264,16582,16974,290
2020, Arkansas,Chicot County,05017,2020,10208,3953,9627,581
2000, Arkansas,Chicot County,05017,2000,14117,6104,13710,407
2020, Arkansas,Arkansas County,05001,2020,17149,11698,16513,636
2000, Arkansas,Johnson County,05071,2000,22781,21344,21254,1527
2000, Arkansas,Hot Spring County,05059,2000,30353,26508,29969,384
2010, Arkansas,Arkansas County,05001,2010,19019,13659,18506,513
2000, Arkansas,Arkansas County,05001,2000,20749,15602,20592,157
2020, Arkansas,Hot Spring County,05059,2020,33040,26525,31775,1265
2010, Arkansas,Chicot County,05017,2010,11800,4864,11258,542
2010, Arkansas,Hot Spring County,05059,2010,32923,28179,32004,919
2010, Arkansas,Pulaski County,05119,2010,382748,220051,360580,22168
2010, Arkansas,Prairie County,05117,2010,8715,7529,8634,81
2000, Arkansas,Pulaski County,05119,2000,361474,231211,352658,8816
2010, Arkansas,Johnson County,05071,2010,25540,22280,22446,3094
2000, Arkansas,White County,05145,2000,67165,62811,65901,1264
2010, Arkansas,Saline County,05125,2010,107118,96978,103031,4087
2000, Arkansas,Saline County,05125,2000,83529,79575,82439,1090
2020, Arkansas,White County,05145,2020,76822,65237,73323,3499
2010, Arkansas,Izard County,05065,2010,13696,13118,13488,208
2020, Arkansas,Izard County,05065,2020,13577,12306,13251,326
2000, Arkansas,Izard County,05065,2000,13249,12773,13116,133
2010, Arkansas,White County,05145,2010,77076,70425,74197,2879
2010, Arkansas,Pope County,05115,2010,61754,55273,57586,4168
2010, Arkansas,Washington County,05143,2010,203065,162253,171607,31458
2020, Arkansas,Washington County,05143,2020,245871,168351,201116,44755
2020, Arkansas,Randolph County,05121,2020,18571,16684,18187,384
2000, Arkansas,Garland County,05051,2000,88068,78250,85814,2254
2000, Arkansas,Prairie County,05117,2000,9539,8092,9462,77
2020, Arkansas,Prairie County,05117,2020,8282,6964,8137,145
2000, Arkansas,Stone County,05137,2000,11499,11185,11375,124
2010, Arkansas,Stone County,05137,2010,12394,11995,12237,157
2000, Arkansas,Ashley County,05003,2000,24209,16892,23433,776
2000, Arkansas,Newton County,05101,2000,8608,8385,8515,93
2000, Arkansas,Craighead County,05031,2000,82148,73332,80409,1739
2020, Arkansas,Ashley County,05003,2020,19062,12958,17948,1114
2010, Arkansas,Ashley County,05003,2010,21853,15143,20784,1069
2020, Arkansas,Independence County,05063,2020,37938,32108,34680,3258
2010, Arkansas,Independence County,05063,2010,36647,33688,34508,2139
2020, Arkansas,Craighead County,05031,2020,111231,80639,104504,6727
2010, Arkansas,Craighead County,05031,2010,96443,78323,92166,4277
2010, Arkansas,Desha County,05041,2010,13008,6230,12430,578
2000, Arkansas,Pope County,05115,2000,54469,51055,53346,1123
2000, Arkansas,Independence County,05063,2000,34233,32490,33710,523
2020, Arkansas,Desha County,05041,2020,11395,4845,10622,773
2000, Arkansas,Randolph County,05121,2000,18195,17648,18046,149
2010, Arkansas,Randolph County,05121,2010,17969,17339,17686,283
2010, Arkansas,Howard County,05061,2010,13789,9894,12440,1349
2000, Arkansas,Howard County,05061,2000,14300,10525,13573,727
2020, Arkansas,Howard County,05061,2020,12785,8164,11268,1517
2020, Arkansas,Crawford County,05033,2020,60133,48610,55566,4567
2010, Arkansas,Lafayette County,05073,2010,7645,4642,7514,131
2020, Arkansas,Lafayette County,05073,2020,6308,3906,6163,145
2000, Arkansas,Lafayette County,05073,2000,8559,5313,8471,88
2010, Arkansas,Crawford County,05033,2010,61948,55194,58188,3760
2000, Arkansas,Crawford County,05033,2000,53247,49087,51504,1743
2000, Arkansas,Sebastian County,05131,2000,115071,94745,107361,7710
2020, Arkansas,Sharp County,05135,2020,17271,15876,16909,362
2000, Arkansas,Desha County,05041,2000,15341,7747,14856,485
2020, Arkansas,Faulkner County,05045,2020,123498,94088,116708,6790
2020, Arkansas,Pulaski County,05119,2020,399125,199197,365972,33153
2020, Arkansas,Columbia County,05027,2020,22801,13371,22028,773
2000, Arkansas,Searcy County,05129,2000,8261,8035,8175,86
2010, Arkansas,Searcy County,05129,2010,8195,7867,8074,121
2020, Arkansas,Johnson County,05071,2020,25749,20088,22310,3439
2020, Arkansas,Garland County,05051,2020,100180,78837,93133,7047
2010, Arkansas,Yell County,05149,2010,22185,19226,17955,4230
2020, Arkansas,Pope County,05115,2020,63381,51409,56966,6415
2000, Arkansas,Madison County,05087,2000,14243,13665,13807,436
2020, Arkansas,Yell County,05149,2020,20263,15330,16059,4204
2020, Arkansas,Madison County,05087,2020,16521,14275,15631,890
2010, Arkansas,Madison County,05087,2010,15717,14711,14958,759
2000, Arkansas,Yell County,05149,2000,21139,18312,18448,2691
2020, Arkansas,Montgomery County,05097,2020,8484,7577,8069,415
2000, Arkansas,Montgomery County,05097,2000,9245,8822,9011,234
2010, Arkansas,Montgomery County,05097,2010,9487,8958,9126,361
2010, Arkansas,Garland County,05051,2010,96024,82964,91402,4622
2000, Arkansas,Nevada County,05099,2000,9955,6660,9804,151
2010, Arkansas,Union County,05139,2010,41639,26276,40179,1460
2020, Arkansas,Nevada County,05099,2020,8310,5218,7956,354
2000, Arkansas,Union County,05139,2000,45629,30182,45109,520
2020, Arkansas,Union County,05139,2020,39054,23216,37300,1754
2010, Arkansas,Nevada County,05099,2010,8997,5933,8777,220
2020, Arkansas,Searcy County,05129,2020,7828,7123,7688,140
2020, Arkansas,Sebastian County,05131,2020,127799,86828,108471,19328
2020, Arkansas,Stone County,05137,2020,12359,11488,12088,271
2000, Arkansas,Faulkner County,05045,2000,86014,75973,84505,1509
2000, Arkansas,Columbia County,05027,2000,25603,15894,25334,269
2020, Arkansas,Jackson County,05067,2020,16755,12890,16294,461
2010, Arkansas,Conway County,05029,2010,21273,17917,20516,757
2010, Arkansas,Columbia County,05027,2010,24552,14696,24019,533
2020, Arkansas,Conway County,05029,2020,20715,16367,19829,886
2010, Arkansas,Jackson County,05067,2010,17997,14363,17561,436
2000, Arkansas,Conway County,05029,2000,20336,17137,19977,359
2000, Arkansas,Jackson County,05067,2000,18418,14840,18184,234
2010, Arkansas,Faulkner County,05045,2010,113237,95420,108802,4435
2010, California,Santa Cruz County,06087,2010,262382,190208,178290,84092
2010, California,Tehama County,06103,2010,63463,51721,49557,13906
2020, California,Ventura County,06111,2020,843843,428677,478558,365285
2020, California,Tehama County,06103,2020,65829,44926,47891,17938
2020, California,Santa Barbara County,06083,2020,448229,224748,237645,210584
2010, California,Sonoma County,06097,2010,483878,371412,363448,120430
2010, California,San Bernardino County,06071,2010,2035210,1153161,1034065,1001145
2020, California,Trinity County,06105,2020,16112,11627,15175,937
2020, California,Napa County,06055,2020,138019,76158,89190,48829
2010, California,Napa County,06055,2010,136484,97525,92474,44010
2010, California,Ventura County,06111,2010,823318,565804,491751,331567
2010, California,Modoc County,06049,2010,9686,8084,8344,1342
2010, California,Santa Clara County,06085,2010,1781642,836616,1302432,479210
2000, California,San Diego County,06073,2000,2813833,1871839,2062868,750965
2010, California,Trinity County,06105,2010,13786,12033,12827,959
2000, California,Trinity County,06105,2000,13022,11573,12505,517
2010, California,Lake County,06033,2010,64665,52033,53577,11088
2000, California,Lake County,06033,2000,58309,50289,51670,6639
2020, California,Lake County,06033,2020,68163,46858,52721,15442
2010, California,Fresno County,06019,2010,930450,515145,462380,468070
2000, California,Fresno County,06019,2000,799407,434045,447771,351636
2000, California,Modoc County,06049,2000,9449,8120,8361,1088
2020, California,Mendocino County,06045,2020,91601,59510,67668,23933
2000, California,Madera County,06039,2000,123109,76612,68594,54515
2000, California,Imperial County,06025,2000,142361,70290,39544,102817
2020, California,Imperial County,06025,2020,179702,47537,26675,153027
2010, California,Imperial County,06025,2010,174528,102553,34257,140271
2020, California,Santa Cruz County,06087,2020,270861,160565,176562,94299
2020, California,Modoc County,06049,2020,8700,6772,7441,1259
2020, California,San Diego County,06073,2020,3298634,1633129,2179005,1119629
2000, California,Yuba County,06115,2000,60219,42537,49770,10449
2000, California,Ventura County,06111,2000,753197,526721,501463,251734
2020, California,Tulare County,06107,2020,473117,186255,163222,309895
2010, California,San Diego County,06073,2010,3095313,1981442,2103965,991348
2010, California,Tulare County,06107,2010,442179,265618,174114,268065
2000, California,Tulare County,06107,2000,368021,213751,181175,186846
2020, California,San Benito County,06069,2020,64209,27230,24968,39241
2010, California,Butte County,06007,2010,220000,180096,188884,31116
2000, California,Tuolumne County,06109,2000,54501,48750,50056,4445
2000, California,Santa Barbara County,06083,2000,399347,290418,262679,136668
2010, California,Santa Barbara County,06083,2010,423895,295124,242208,181687
2010, California,Stanislaus County,06099,2010,514453,337342,298795,215658
2000, California,Riverside County,06065,2000,1545387,1013478,985812,559575
2010, California,Riverside County,06065,2010,2189641,1335147,1194384,995257
2000, California,Contra Costa County,06013,2000,948816,621490,781040,167776
2020, California,Tuolumne County,06109,2020,55620,44207,48496,7124
2010, California,Tuolumne County,06109,2010,55365,48274,49447,5918
2000, California,Napa County,06055,2000,124279,99396,94863,29416
2020, California,Butte County,06007,2020,211632,149557,171520,40112
2000, California,Santa Clara County,06085,2000,1682585,905660,1279184,403401
2020, California,Riverside County,06065,2020,2418185,995627,1215890,1202295
2020, California,Santa Clara County,06085,2020,1936259,622617,1448902,487357
2000, California,Stanislaus County,06099,2000,446997,309901,305126,141871
2000, California,Tehama County,06103,2000,56039,47518,47168,8871
2020, California,Contra Costa County,06013,2020,1165927,501697,851027,314900
2020, California,Inyo County,06027,2020,19016,11752,14617,4399
2010, California,Inyo County,06027,2010,18546,13741,14949,3597
2000, California,Sierra County,06091,2000,3555,3348,3342,213
2010, California,Sierra County,06091,2010,3240,3022,2971,269
2020, California,Sierra County,06091,2020,3236,2703,2859,377
2000, California,Inyo County,06027,2000,17945,14367,15688,2257
2000, California,Butte County,06007,2000,203171,171728,181832,21339
2000, California,Santa Cruz County,06087,2000,255602,191931,187116,68486
2020, California,San Bernardino County,06071,2020,2181654,782691,1010741,1170913
2010, California,Monterey County,06053,2010,415057,230717,185054,230003
2000, California,Sonoma County,06097,2000,458614,374209,379103,79511
2010, California,Contra Costa County,06013,2010,1049025,614512,793465,255560
2000, California,Monterey County,06053,2000,401762,224682,213793,187969
2010, California,San Benito County,06069,2010,55269,35181,24083,31186
2020, California,Monterey County,06053,2020,439035,158879,173714,265321
2000, California,San Bernardino County,06071,2000,1709434,1006960,1040047,669387
2010, California,Madera County,06039,2010,150865,94456,69873,80992
2020, California,Merced County,06047,2020,281202,104534,107345,173857
2010, California,Mendocino County,06045,2010,87841,67218,68336,19505
2010, California,Shasta County,06089,2010,177223,153726,162345,14878
2020, California,Sacramento County,06067,2020,1585055,715722,1210621,374434
2010, California,Los Angeles County,06037,2010,9818605,4936599,5130716,4687889
2000, California,Plumas County,06063,2000,20824,19113,19647,1177
2020, California,Plumas County,06063,2020,19790,16608,17893,1897
2010, California,Plumas County,06063,2010,20007,17797,18402,1605
2000, California,Calaveras County,06009,2000,40554,36982,37789,2765
2010, California,Del Norte County,06015,2010,28610,21098,23517,5093
2000, California,Del Norte County,06015,2000,27507,21693,23678,3829
2000, California,Mariposa County,06043,2000,17130,15234,15801,1329
2020, California,Mariposa County,06043,2020,17131,13385,14991,2140
2010, California,Orange County,06059,2010,3010232,1830758,1997259,1012973
2010, California,Mariposa County,06043,2010,18251,16103,16575,1676
2010, California,Solano County,06095,2010,413344,210751,313988,99356
2020, California,Kings County,06031,2020,152486,61226,65879,86607
2000, California,Placer County,06061,2000,248399,220053,224380,24019
2010, California,Placer County,06061,2010,348432,290977,303722,44710
2020, California,Alpine County,06003,2020,1204,814,1120,84
2000, California,Amador County,06005,2000,35100,30113,31974,3126
2020, California,Placer County,06061,2020,404739,288586,344111,60628
2010, California,Amador County,06005,2010,38091,33149,33335,4756
2020, California,Del Norte County,06015,2020,27743,17193,22422,5321
2010, California,Calaveras County,06009,2010,45578,40522,40875,4703
2020, California,Calaveras County,06009,2020,45292,36315,39427,5865
2020, California,San Mateo County,06081,2020,764442,300188,573056,191386
2020, California,Yuba County,06115,2020,81575,46590,58055,23520
2010, California,Sacramento County,06067,2010,1418788,815151,1112592,306196
2020, California,El Dorado County,06017,2020,191185,146624,164726,26459
2020, California,Stanislaus County,06099,2020,552878,256602,286900,265978
2020, California,Siskiyou County,06093,2020,44076,33597,38549,5527
2020, California,Nevada County,06057,2020,102241,85604,91825,10416
2010, California,Nevada County,06057,2010,98764,90233,90325,8439
2000, California,Nevada County,06057,2000,92033,85948,86832,5201
2010, California,Siskiyou County,06093,2010,44900,38030,40285,4615
2010, California,Kern County,06029,2010,839631,499766,426598,413033
2020, California,Sonoma County,06097,2020,488863,306684,347425,141438
2000, California,Glenn County,06021,2000,26453,18988,18613,7840
2010, California,Glenn County,06021,2010,28122,19990,17583,10539
2020, California,Lassen County,06035,2020,32730,21066,25199,7531
2000, California,Sacramento County,06067,2000,1223499,783240,1027609,195890
2020, California,Fresno County,06019,2020,1008654,374678,467911,540743
2010, California,Lassen County,06035,2010,34895,25532,28778,6117
2000, California,Lassen County,06035,2000,33828,27336,29147,4681
2020, California,Glenn County,06021,2020,28917,15753,16376,12541
2010, California,El Dorado County,06017,2010,181058,156793,159183,21875
2000, California,El Dorado County,06017,2000,156299,140209,141733,14566
2010, California,Alpine County,06003,2010,1175,881,1091,84
2000, California,Alpine County,06003,2000,1208,890,1114,94
2000, California,Shasta County,06089,2000,163256,145826,154258,8998
2000, California,Kern County,06029,2000,661645,407581,407609,254036
2000, California,Orange County,06059,2000,2846289,1844652,1970710,875579
2020, California,Orange County,06059,2020,3186989,1383257,2100155,1086834
2020, California,Kern County,06029,2020,909235,371734,410077,499158
2010, California,Yuba County,06115,2010,72155,49332,54104,18051
2020, California,Solano County,06095,2020,453491,175768,325336,128155
2020, California,Madera County,06039,2020,156255,65248,63077,93178
2000, California,Colusa County,06011,2000,18804,12090,10052,8752
2000, California,Solano County,06095,2000,394542,222387,324944,69598
2000, California,San Joaquin County,06077,2000,563598,327607,391525,172073
2020, California,San Joaquin County,06077,2020,779233,267339,453508,325725
2010, California,San Joaquin County,06077,2010,685306,349287,418965,266341
2020, California,Alameda County,06001,2020,1682353,523836,1288604,393749
2010, California,San Francisco County,06075,2010,805235,390387,683461,121774
2020, California,San Francisco County,06075,2020,873965,361382,737204,136761
2000, California,Los Angeles County,06037,2000,9519338,4637062,5277125,4242213
2000, California,San Francisco County,06075,2000,776733,385728,667229,109504
2010, California,Mono County,06051,2010,14202,11697,10440,3762
2020, California,Mono County,06051,2020,13195,9349,9688,3507
2000, California,Humboldt County,06023,2000,126518,107179,118308,8210
2020, California,Humboldt County,06023,2020,136463,98095,117928,18535
2010, California,Humboldt County,06023,2010,134623,109920,121412,13211
2000, California,Mono County,06051,2000,12853,10818,10579,2274
2000, California,Siskiyou County,06093,2000,44301,38573,40947,3354
2000, California,Merced County,06047,2000,210554,118350,115088,95466
2010, California,Merced County,06047,2010,255793,148381,115308,140485
2000, California,San Mateo County,06081,2000,707161,420683,552453,154708
2010, California,San Mateo County,06081,2010,718451,383535,535949,182502
2000, California,Mendocino County,06045,2000,86265,69671,72052,14213
2000, California,Marin County,06041,2000,247289,207800,219938,27351
2010, California,Marin County,06041,2010,252409,201963,213340,39069
2020, California,Marin County,06041,2020,262321,179377,212911,49410
2000, California,Alameda County,06001,2000,1443741,704334,1169831,273910
2010, California,Alameda County,06001,2010,1510271,649122,1170382,339889
2010, California,Colusa County,06011,2010,21419,13854,9615,11804
2010, California,Sutter County,06101,2010,94737,57749,67486,27251
2000, California,San Benito County,06069,2000,53234,34695,27718,25516
2000, California,Kings County,06031,2000,129461,69492,73000,56461
2000, California,Yolo County,06113,2000,168660,114129,124953,43707
2020, California,Sutter County,06101,2020,99633,46810,68065,31568
2010, California,Kings County,06031,2010,152982,83027,75116,77866
2020, California,San Luis Obispo County,06079,2020,282424,198338,214503,67921
2020, California,Amador County,06005,2020,40474,31104,34460,6014
2000, California,San Luis Obispo County,06079,2000,246681,208699,206485,40196
2010, California,San Luis Obispo County,06079,2010,269637,222756,213664,55973
2000, California,Sutter County,06101,2000,78930,53291,61401,17529
2020, California,Yolo County,06113,2020,216403,107304,144703,71700
2020, California,Los Angeles County,06037,2020,10014009,3259427,5209246,4804763
2020, California,Shasta County,06089,2020,182155,142899,162425,19730
2010, California,Yolo County,06113,2010,200849,126883,139896,60953
2020, California,Colusa County,06011,2020,21839,9364,8363,13476
2000, Colorado,Delta County,08029,2000,27834,25688,24663,3171
2020, Colorado,Delta County,08029,2020,31196,26117,26867,4329
2000, Colorado,Kit Carson County,08063,2000,8011,6992,6916,1095
2020, Colorado,Garfield County,08045,2020,61685,42038,42121,19564
2010, Colorado,Delta County,08029,2010,30952,27761,26607,4345
2010, Colorado,Saguache County,08109,2010,6108,5024,3656,2452
2010, Colorado,Phillips County,08095,2010,4442,3961,3612,830
2000, Colorado,Phillips County,08095,2000,4480,4168,3953,527
2020, Colorado,Mesa County,08077,2020,155703,127970,132425,23278
2000, Colorado,Park County,08093,2000,14523,13807,13895,628
2000, Colorado,Saguache County,08109,2000,5917,4218,3239,2678
2010, Colorado,Lincoln County,08073,2010,5467,4868,4784,683
2020, Colorado,Lincoln County,08073,2020,5675,4397,4866,809
2000, Colorado,Lincoln County,08073,2000,6087,5253,5568,519
2020, Colorado,Dolores County,08033,2020,2326,2021,2150,176
2020, Colorado,Park County,08093,2020,17390,15318,16155,1235
2010, Colorado,Mesa County,08077,2010,146723,131181,127171,19552
2020, Colorado,Phillips County,08095,2020,4530,3500,3375,1155
2020, Colorado,Douglas County,08035,2020,357978,289005,323868,34110
2010, Colorado,Gilpin County,08047,2010,5441,5157,5174,267
2000, Colorado,Gilpin County,08047,2000,4757,4489,4555,202
2020, Colorado,Denver County,08031,2020,715522,433946,516062,199460
2000, Colorado,Douglas County,08035,2000,175766,163064,166880,8886
2010, Colorado,Douglas County,08035,2010,285465,257598,264073,21392
2020, Colorado,Broomfield County,08014,2020,74112,56334,64193,9919
2010, Colorado,Park County,08093,2010,16206,15352,15423,783
2010, Colorado,Broomfield County,08014,2010,55889,48099,49673,6216
2010, Colorado,Logan County,08075,2010,22709,20213,19158,3551
2000, Colorado,Mesa County,08077,2000,116255,107349,104604,11651
2000, Colorado,Logan County,08075,2000,20504,18792,18065,2439
2020, Colorado,Gilpin County,08047,2020,5808,5077,5428,380
2020, Colorado,Logan County,08075,2020,21528,17261,18017,3511
2000, Colorado,Denver County,08031,2000,554636,362180,378932,175704
2020, Colorado,Cheyenne County,08017,2020,1748,1534,1542,206
2010, Colorado,Cheyenne County,08017,2010,1836,1711,1658,178
2000, Colorado,Cheyenne County,08017,2000,2231,2072,2050,181
2010, Colorado,Grand County,08049,2010,14843,13877,13727,1116
2020, Colorado,Grand County,08049,2020,15717,13772,14184,1533
2000, Colorado,Garfield County,08045,2000,43791,39394,36491,7300
2010, Colorado,Denver County,08031,2010,600158,413696,409193,190965
2020, Colorado,Yuma County,08125,2020,9988,7437,7217,2771
2000, Colorado,Grand County,08049,2000,12442,11839,11899,543
2010, Colorado,Garfield County,08045,2010,56389,46367,40411,15978
2010, Colorado,Dolores County,08033,2010,2064,1920,1982,82
2010, Colorado,Boulder County,08013,2010,294567,256889,255291,39276
2010, Colorado,Elbert County,08039,2010,23086,21861,21852,1234
2010, Colorado,Kiowa County,08061,2010,1398,1346,1320,78
2000, Colorado,Hinsdale County,08053,2000,790,769,778,12
2010, Colorado,Hinsdale County,08053,2010,843,802,819,24
2020, Colorado,Hinsdale County,08053,2020,788,706,758,30
2020, Colorado,Washington County,08121,2020,4817,4230,4301,516
2010, Colorado,Washington County,08121,2010,4814,4588,4407,407
2000, Colorado,Las Animas County,08071,2000,15207,12566,8903,6304
2020, Colorado,Las Animas County,08071,2020,14555,10035,8923,5632
2010, Colorado,Las Animas County,08071,2010,15507,12967,9061,6446
2000, Colorado,Larimer County,08069,2000,251494,229976,230683,20811
2020, Colorado,Larimer County,08069,2020,359066,295995,314404,44662
2000, Colorado,Kiowa County,08061,2000,1622,1559,1571,51
2010, Colorado,Larimer County,08069,2010,299630,271267,268002,31628
2020, Colorado,Sedgwick County,08115,2020,2404,2062,2041,363
2000, Colorado,Sedgwick County,08115,2000,2747,2486,2433,314
2020, Colorado,Kiowa County,08061,2020,1446,1290,1342,104
2020, Colorado,San Juan County,08111,2020,705,606,615,90
2010, Colorado,San Juan County,08111,2010,699,647,615,84
2020, Colorado,Elbert County,08039,2020,26062,22817,23995,2067
2010, Colorado,Montrose County,08085,2010,41276,35804,33149,8127
2020, Colorado,Summit County,08117,2020,31055,24751,25720,5335
2010, Colorado,Morgan County,08087,2010,28159,22360,18653,9506
2000, Colorado,Routt County,08107,2000,19690,19079,19056,634
2010, Colorado,Rio Grande County,08105,2010,11982,9379,6896,5086
2010, Colorado,Adams County,08001,2010,441603,323795,273725,167878
2020, Colorado,Adams County,08001,2020,519572,289718,302923,216649
2000, Colorado,Rio Grande County,08105,2000,12413,9177,7241,5172
2020, Colorado,Rio Grande County,08105,2020,11539,8093,6930,4609
2010, Colorado,Rio Blanco County,08103,2010,6666,6123,6001,665
2020, Colorado,Rio Blanco County,08103,2020,6529,5699,5907,622
2000, Colorado,Rio Blanco County,08103,2000,5986,5687,5690,296
2000, Colorado,Chaffee County,08015,2000,16242,14771,14849,1393
2020, Colorado,Chaffee County,08015,2020,19476,16693,17635,1841
2010, Colorado,Chaffee County,08015,2010,17809,16598,16131,1678
2000, Colorado,El Paso County,08041,2000,516929,419673,458528,58401
2010, Colorado,El Paso County,08041,2010,622263,496258,528598,93665
2020, Colorado,El Paso County,08041,2020,730395,516911,600411,129984
2010, Colorado,Summit County,08117,2010,27994,25103,24005,3989
2000, Colorado,Elbert County,08039,2000,19872,18923,19106,766
2020, Colorado,Boulder County,08013,2020,330758,255983,282590,48168
2020, Colorado,Morgan County,08087,2020,29111,19184,18545,10566
2000, Colorado,Summit County,08117,2000,23548,21626,21242,2306
2020, Colorado,Routt County,08107,2020,24829,21726,22629,2200
2000, Colorado,Montrose County,08085,2000,33432,30074,28465,4967
2020, Colorado,Montrose County,08085,2020,42679,33395,33652,9027
2000, Colorado,Conejos County,08021,2000,8400,6112,3451,4949
2000, Colorado,Pueblo County,08101,2000,141472,112430,87762,53710
2020, Colorado,Archuleta County,08007,2020,13359,10749,11200,2159
2010, Colorado,Archuleta County,08007,2010,12084,10436,9936,2148
2000, Colorado,Archuleta County,08007,2000,9898,8743,8239,1659
2000, Colorado,Arapahoe County,08005,2000,487967,390048,430355,57612
2010, Colorado,Arapahoe County,08005,2010,572003,415910,466481,105522
2020, Colorado,Arapahoe County,08005,2020,655070,396027,519341,135729
2020, Colorado,Montezuma County,08083,2020,25849,18958,22740,3109
2010, Colorado,Costilla County,08023,2010,3524,2397,1197,2327
2020, Colorado,Costilla County,08023,2020,3499,1827,1511,1988
2010, Colorado,Jackson County,08057,2010,1394,1290,1244,150
2020, Colorado,Jackson County,08057,2020,1379,1199,1241,138
2000, Colorado,Jackson County,08057,2000,1577,1517,1474,103
2000, Colorado,Costilla County,08023,2000,3663,2231,1187,2476
2010, Colorado,Montezuma County,08083,2010,25535,20704,22717,2818
2020, Colorado,La Plata County,08067,2020,55638,44366,48630,7008
2010, Colorado,La Plata County,08067,2010,51334,44546,45278,6056
2000, Colorado,La Plata County,08067,2000,43941,38364,39370,4571
2010, Colorado,Conejos County,08021,2010,8256,6293,3636,4620
2010, Colorado,Sedgwick County,08115,2010,2379,2194,2090,289
2010, Colorado,Pueblo County,08101,2010,159063,126229,93252,65811
2010, Colorado,Prowers County,08099,2010,12551,10165,8134,4417
2000, Colorado,Washington County,08121,2000,4926,4748,4616,310
2020, Colorado,Baca County,08009,2020,3506,3043,3160,346
2000, Colorado,Baca County,08009,2000,4517,4234,4200,317
2010, Colorado,Baca County,08009,2010,3788,3506,3440,348
2020, Colorado,Huerfano County,08055,2020,6820,4997,4690,2130
2000, Colorado,Huerfano County,08055,2000,7862,6365,5099,2763
2010, Colorado,Huerfano County,08055,2010,6711,5560,4343,2368
2020, Colorado,San Miguel County,08113,2020,8072,6922,7190,882
2000, Colorado,Lake County,08065,2000,7812,6062,4989,2823
2020, Colorado,Lake County,08065,2020,7436,4996,4774,2662
2010, Colorado,San Miguel County,08113,2010,7359,6837,6729,630
2010, Colorado,Lake County,08065,2010,7310,5898,4452,2858
2000, Colorado,San Miguel County,08113,2000,6594,6170,6155,439
2010, Colorado,Yuma County,08125,2010,10043,8861,7955,2088
2000, Colorado,Montezuma County,08083,2000,23830,19474,21567,2263
2000, Colorado,Yuma County,08125,2000,9841,9267,8573,1268
2020, Colorado,Conejos County,08021,2020,7461,5045,3682,3779
2020, Colorado,Prowers County,08099,2020,11999,8131,7319,4680
2000, Colorado,Prowers County,08099,2000,14483,11379,9717,4766
2020, Colorado,Pueblo County,08101,2020,168162,108805,98241,69921
2010, Colorado,Routt County,08107,2010,23509,22279,21909,1600
2000, Colorado,Morgan County,08087,2000,27171,21642,18698,8473
2010, Colorado,Moffat County,08081,2010,13795,12422,11810,1985
2000, Colorado,Fremont County,08043,2000,46145,41311,41369,4776
2010, Colorado,Teller County,08119,2010,23350,22008,22056,1294
2020, Colorado,Teller County,08119,2020,24710,21566,22994,1716
2000, Colorado,Custer County,08027,2000,3503,3359,3415,88
2020, Colorado,Mineral County,08079,2020,865,789,818,47
2010, Colorado,Mineral County,08079,2010,712,693,691,21
2000, Colorado,Mineral County,08079,2000,831,805,814,17
2020, Colorado,Saguache County,08109,2020,6368,4209,3974,2394
2000, Colorado,Alamosa County,08003,2000,14966,10654,8769,6197
2020, Colorado,Alamosa County,08003,2020,16376,10069,8675,7701
2000, Colorado,Otero County,08089,2000,20311,16049,12669,7642
2010, Colorado,Otero County,08089,2010,18831,14788,11235,7596
2020, Colorado,Otero County,08089,2020,18690,12847,10988,7702
2010, Colorado,Fremont County,08043,2010,46824,42225,41054,5770
2020, Colorado,Clear Creek County,08019,2020,9397,8323,8749,648
2010, Colorado,Jefferson County,08059,2010,534543,472694,458098,76445
2000, Colorado,Clear Creek County,08019,2000,9322,8984,8961,361
2010, Colorado,Clear Creek County,08019,2010,9088,8664,8659,429
2020, Colorado,Custer County,08027,2020,4704,4279,4526,178
2000, Colorado,Jefferson County,08059,2000,527056,477454,474607,52449
2020, Colorado,Jefferson County,08059,2020,582910,460764,491396,91514
2010, Colorado,Alamosa County,08003,2010,15445,11549,8335,7110
2020, Colorado,Weld County,08123,2020,328981,231892,230519,98462
2000, Colorado,Weld County,08123,2000,180936,147834,132001,48935
2020, Colorado,Pitkin County,08097,2020,17358,14797,15466,1892
2020, Colorado,Moffat County,08081,2020,13292,10872,11168,2124
2000, Colorado,Moffat County,08081,2000,13184,12341,11937,1247
2010, Colorado,Weld County,08123,2010,252825,209594,181145,71680
2000, Colorado,Dolores County,08033,2000,1844,1757,1773,71
2020, Colorado,Fremont County,08043,2020,48939,39965,42890,6049
2000, Colorado,Teller County,08119,2000,20555,19510,19837,718
2020, Colorado,Kit Carson County,08063,2020,7087,5649,5678,1409
2000, Colorado,Boulder County,08013,2000,291288,257909,260832,30456
2000, Colorado,Pitkin County,08097,2000,14872,14029,13899,973
2020, Colorado,Crowley County,08025,2020,5922,3747,4314,1608
2020, Colorado,Ouray County,08091,2020,4874,4396,4582,292
2010, Colorado,Ouray County,08091,2010,4436,4277,4240,196
2010, Colorado,Crowley County,08025,2010,5823,4509,4137,1686
2000, Colorado,Ouray County,08091,2000,3742,3605,3590,152
2000, Colorado,Crowley County,08025,2000,5518,4577,4274,1244
2010, Colorado,Pitkin County,08097,2010,17148,16028,15587,1561
2000, Colorado,Bent County,08011,2000,5998,4770,4184,1814
2020, Colorado,Gunnison County,08051,2020,16918,14652,15314,1604
2020, Colorado,Bent County,08011,2020,5650,3831,3890,1760
2010, Colorado,Bent County,08011,2010,6499,5149,4514,1985
2010, Colorado,Gunnison County,08051,2010,15324,14152,14069,1255
2010, Colorado,Custer County,08027,2010,4255,4055,4055,200
2010, Colorado,Eagle County,08037,2010,52197,43402,36508,15689
2020, Colorado,Eagle County,08037,2020,55731,39594,38873,16858
2000, Colorado,Eagle County,08037,2000,41659,35558,31977,9682
2000, Colorado,San Juan County,08111,2000,558,542,517,41
2000, Colorado,Adams County,08001,2000,363857,281231,261272,102585
2010, Colorado,Kit Carson County,08063,2010,8270,7316,6696,1574
2000, Colorado,Gunnison County,08051,2000,13956,13269,13256,700
2010, Connecticut,Middlesex County,09007,2010,165676,147823,157842,7834
2010, Connecticut,Litchfield County,09005,2010,189927,178268,181392,8535
2000, Connecticut,Litchfield County,09005,2000,182193,174484,178299,3894
2020, Connecticut,Windham County,09015,2020,116418,95023,101959,14459
2010, Connecticut,Windham County,09015,2010,118428,106100,107077,11351
2000, Connecticut,Windham County,09015,2000,109091,99567,101354,7737
2020, Connecticut,Litchfield County,09005,2020,185186,158774,170606,14580
2020, Connecticut,New Haven County,09009,2020,864835,543831,694754,170081
2010, Connecticut,Hartford County,09003,2010,894014,647237,757231,136783
2020, Connecticut,Tolland County,09013,2020,149788,122869,140089,9699
2000, Connecticut,Middlesex County,09007,2000,155071,141555,150422,4649
2020, Connecticut,Hartford County,09003,2020,899498,554184,733223,166275
2010, Connecticut,New Haven County,09009,2010,862477,644744,732734,129743
2010, Connecticut,Tolland County,09013,2010,152691,137125,146089,6602
2000, Connecticut,Tolland County,09013,2000,136364,125915,132491,3873
2000, Connecticut,New Haven County,09009,2000,824008,654244,740877,83131
2000, Connecticut,Hartford County,09003,2000,857183,659192,758215,98968
2010, Connecticut,Fairfield County,09001,2010,916829,685900,761804,155025
2000, Connecticut,New London County,09011,2000,259088,225406,245852,13236
2020, Connecticut,New London County,09011,2020,268555,201548,237635,30920
2020, Connecticut,Fairfield County,09001,2020,957419,584184,752068,205351
2000, Connecticut,Fairfield County,09001,2000,882567,699992,777732,104835
2020, Connecticut,Middlesex County,09007,2020,164245,134715,152317,11928
2010, Connecticut,New London County,09011,2010,274055,225213,250841,23214
2010, Delaware,Kent County,10001,2010,162310,109999,152964,9346
2000, Delaware,Kent County,10001,2000,126697,93106,122628,4069
2020, Delaware,Kent County,10001,2020,181851,107685,167870,13981
2010, Delaware,Sussex County,10005,2010,197145,155663,180191,16954
2020, Delaware,Sussex County,10005,2020,237378,175847,210585,26793
2000, Delaware,New Castle County,10003,2000,500265,365810,473972,26293
2010, Delaware,New Castle County,10003,2010,538479,352955,491558,46921
2020, Delaware,New Castle County,10003,2020,570719,314231,507203,63516
2000, Delaware,Sussex County,10005,2000,156638,125857,149723,6915
2020, District of Columbia,District of Columbia,11001,2020,689545,273194,611893,77652
2000, District of Columbia,District of Columbia,11001,2000,572059,176101,527106,44953
2010, District of Columbia,District of Columbia,11001,2010,601723,231471,546974,54749
2000, Florida,Flagler County,12035,2000,49832,43490,47295,2537
2010, Florida,Alachua County,12001,2010,247336,172156,226584,20752
2000, Florida,Osceola County,12097,2000,172493,133169,121766,50727
2020, Florida,Osceola County,12097,2020,388656,157720,177567,211089
2000, Florida,Palm Beach County,12099,2000,1131184,894207,990509,140675
2000, Florida,Gadsden County,12039,2000,45087,17448,42305,2782
2010, Florida,Palm Beach County,12099,2010,1320134,970121,1069311,250823
2020, Florida,Flagler County,12035,2020,115378,87661,103079,12299
2010, Florida,Flagler County,12035,2010,95696,78710,87445,8251
2000, Florida,Madison County,12079,2000,18733,10769,18133,600
2010, Florida,Calhoun County,12013,2010,14625,11818,13870,755
2020, Florida,St. Lucie County,12111,2020,329226,192202,262906,66320
2010, Florida,St. Lucie County,12111,2010,277789,199336,231794,45995
2020, Florida,Escambia County,12033,2020,321905,206982,301112,20793
2000, Florida,Marion County,12083,2000,258916,217909,243300,15616
2020, Florida,Marion County,12083,2020,375908,268563,319998,55910
2010, Florida,Marion County,12083,2010,331298,268284,295161,36137
2020, Florida,Palm Beach County,12099,2020,1492191,855682,1142258,349933
2000, Florida,Alachua County,12001,2000,217955,160128,205462,12493
2010, Florida,Escambia County,12033,2010,297619,204993,283558,14061
2000, Florida,Escambia County,12033,2000,294410,213008,286475,7935
2000, Florida,Martin County,12085,2000,126731,113912,117225,9506
2020, Florida,Martin County,12085,2020,158431,124465,134244,24187
2000, Florida,Okaloosa County,12091,2000,170498,142218,163196,7302
2020, Florida,Union County,12125,2020,16147,11903,15383,764
2000, Florida,St. Lucie County,12111,2000,192695,152504,176962,15733
2000, Florida,Union County,12125,2000,13442,9896,12965,477
2000, Florida,Franklin County,12037,2000,11057,8983,10789,268
2000, Florida,Calhoun County,12013,2000,13017,10397,12525,492
2020, Florida,Calhoun County,12013,2020,13648,10741,13026,622
2010, Florida,Charlotte County,12015,2010,159978,144059,150765,9213
2010, Florida,Duval County,12031,2010,864263,526044,798865,65398
2010, Florida,Franklin County,12037,2010,11549,9540,11020,529
2020, Florida,Franklin County,12037,2020,12451,10002,11776,675
2020, Florida,Charlotte County,12015,2020,186847,157543,172768,14079
2020, Florida,Okeechobee County,12093,2020,39644,27333,29787,9857
2010, Florida,Martin County,12085,2010,146318,127691,128437,17881
2010, Florida,Okeechobee County,12093,2010,39996,31009,30435,9561
2000, Florida,Duval County,12031,2000,778879,512469,746933,31946
2000, Florida,Charlotte County,12015,2000,141627,131125,136960,4667
2020, Florida,Duval County,12031,2020,995567,514782,882878,112689
2000, Florida,Okeechobee County,12093,2000,35910,28468,29226,6684
2000, Florida,Orange County,12095,2000,896344,614830,727983,168361
2010, Florida,Madison County,12079,2010,19224,11070,18325,899
2020, Florida,Madison County,12079,2020,17968,10425,17087,881
2010, Florida,Osceola County,12097,2010,268685,190641,146539,122146
2010, Florida,Orange County,12095,2010,1145956,728795,837712,308244
2020, Florida,Orange County,12095,2020,1429908,629789,956883,473025
2010, Florida,Gadsden County,12039,2010,46389,16646,41970,4419
2020, Florida,Alachua County,12001,2020,278468,170245,244854,33614
2010, Florida,Seminole County,12117,2010,422718,330664,350261,72457
2000, Florida,Seminole County,12117,2000,365196,300948,324465,40731
2020, Florida,Seminole County,12117,2020,470856,289597,364317,106539
2020, Florida,Manatee County,12081,2020,399710,289188,328731,70979
2010, Florida,Manatee County,12081,2010,322833,264322,274878,47955
2000, Florida,Manatee County,12081,2000,264002,227981,239462,24540
2020, Florida,Gadsden County,12039,2020,43826,14936,38733,5093
2010, Florida,Union County,12125,2010,15535,11655,14792,743
2010, Florida,Wakulla County,12129,2010,30776,25224,29760,1016
2020, Florida,Okaloosa County,12091,2020,211668,151861,189090,22578
2010, Florida,Walton County,12131,2010,55043,48351,52122,2921
2000, Florida,Washington County,12133,2000,20973,17140,20490,483
2020, Florida,Hamilton County,12047,2020,14004,8028,12549,1455
2000, Florida,Hamilton County,12047,2000,13327,7835,12480,847
2010, Florida,Hamilton County,12047,2010,14799,8851,13493,1306
2010, Florida,Highlands County,12055,2010,98786,79972,81629,17157
2020, Florida,Liberty County,12077,2020,7974,5926,7412,562
2000, Florida,Highlands County,12055,2000,87366,72926,76824,10542
2020, Florida,Collier County,12021,2020,375752,257007,273503,102249
2020, Florida,Highlands County,12055,2020,101235,71549,80292,20943
2020, Florida,Walton County,12131,2020,75305,61858,69118,6187
2000, Florida,Liberty County,12077,2000,7021,5365,6705,316
2020, Florida,Taylor County,12123,2020,21796,16047,20930,866
2010, Florida,Taylor County,12123,2010,22570,16964,21793,777
2000, Florida,Taylor County,12123,2000,19256,14988,18961,295
2010, Florida,Collier County,12021,2010,321520,269596,238343,83177
2010, Florida,Liberty County,12077,2010,8365,6462,7847,518
2010, Florida,Hillsborough County,12057,2010,1229226,876137,922591,306635
2000, Florida,Hillsborough County,12057,2000,998948,750903,819256,179692
2020, Florida,Hillsborough County,12057,2020,1459762,767348,1032381,427381
2000, Florida,Columbia County,12023,2000,56513,45053,54967,1546
2020, Florida,Columbia County,12023,2020,69698,50735,64635,5063
2020, Florida,Gulf County,12045,2020,14192,11399,13637,555
2000, Florida,Gulf County,12045,2000,13332,10651,13062,270
2010, Florida,Gulf County,12045,2010,15863,12384,15185,678
2020, Florida,Wakulla County,12129,2020,33764,26614,32187,1577
2010, Florida,Okaloosa County,12091,2010,180822,146582,168526,12296
2000, Florida,Collier County,12021,2000,251377,216345,202081,49296
2000, Florida,Hendry County,12051,2000,36210,23926,21874,14336
2000, Florida,Clay County,12019,2000,140814,123128,134755,6059
2020, Florida,Clay County,12019,2020,218245,154895,195111,23134
2010, Florida,Clay County,12019,2010,190865,156087,176256,14609
2020, Florida,Holmes County,12059,2020,19653,17063,18965,688
2000, Florida,Holmes County,12059,2000,18564,16669,18206,358
2020, Florida,Washington County,12133,2020,25318,19811,24394,924
2010, Florida,Washington County,12133,2010,24896,20014,24163,733
2010, Florida,Holmes County,12059,2010,19927,18043,19483,444
2000, Florida,Wakulla County,12129,2000,22863,19684,22420,443
2000, Florida,Polk County,12105,2000,483924,385099,437991,45933
2000, Florida,Jefferson County,12065,2000,12902,7647,12612,290
2000, Florida,Suwannee County,12121,2000,34844,29455,33141,1703
2000, Florida,Monroe County,12087,2000,79589,72151,67036,12553
2010, Florida,Bay County,12005,2010,168852,138731,160745,8107
2020, Florida,Hernando County,12053,2020,194515,152496,165470,29045
2010, Florida,Monroe County,12087,2010,73090,65409,58019,15071
2000, Florida,Hernando County,12053,2000,130802,121453,124215,6587
2020, Florida,Monroe County,12087,2020,82874,60153,63442,19432
2010, Florida,Hernando County,12053,2010,172778,154598,154982,17796
2020, Florida,Lee County,12071,2020,760822,530637,587661,173161
2010, Florida,Lee County,12071,2010,618754,513496,505446,113308
2000, Florida,Lee County,12071,2000,440888,386598,398846,42042
2020, Florida,Sumter County,12119,2020,129752,112058,122169,7583
2010, Florida,Hendry County,12051,2010,39140,23436,19897,19243
2020, Florida,Hendry County,12051,2020,39619,18446,17507,22112
2010, Florida,Sumter County,12119,2010,93420,80893,87838,5582
2020, Florida,Suwannee County,12121,2020,43474,33024,38689,4785
2020, Florida,Bay County,12005,2020,175216,131304,161370,13846
2000, Florida,Bay County,12005,2000,148217,124761,144626,3591
2010, Florida,Suwannee County,12121,2010,41551,34299,37955,3596
2010, Florida,Levy County,12075,2010,40801,34876,37754,3047
2000, Florida,Levy County,12075,2000,34450,29586,33111,1339
2020, Florida,Levy County,12075,2020,42915,34111,38835,4080
2010, Florida,Jefferson County,12065,2010,14761,8912,14215,546
2010, Florida,Polk County,12105,2010,602095,452854,495563,106532
2000, Florida,Walton County,12131,2000,40601,35896,39721,880
2020, Florida,Polk County,12105,2020,725046,439034,537351,187695
2020, Florida,Jefferson County,12065,2020,14510,8905,13852,658
2020, Florida,Hardee County,12049,2020,25327,14821,14723,10604
2010, Florida,Hardee County,12049,2010,27731,20013,15836,11895
2000, Florida,Pinellas County,12103,2000,921482,791111,878722,42760
2020, Florida,Leon County,12073,2020,292198,163927,269284,22914
2010, Florida,Leon County,12073,2010,275487,173480,260126,15361
2000, Florida,Leon County,12073,2000,239452,158893,231045,8407
2010, Florida,Pinellas County,12103,2010,916542,752892,843301,73241
2020, Florida,Pinellas County,12103,2020,959107,709036,856668,102439
2000, Florida,Hardee County,12049,2000,26938,19035,17327,9611
2010, Florida,Baker County,12003,2010,27115,22686,26595,520
2010, Florida,Columbia County,12023,2010,67531,52611,64255,3276
2000, Florida,Sumter County,12119,2000,53345,44061,49989,3356
2020, Florida,Glades County,12043,2020,12126,8241,9076,3050
2000, Florida,Lafayette County,12067,2000,7022,5566,6380,642
2020, Florida,St. Johns County,12109,2020,273425,220420,250818,22607
2010, Florida,Lafayette County,12067,2010,8870,6868,7794,1076
2020, Florida,Gilchrist County,12041,2020,17864,15170,16516,1348
2010, Florida,Gilchrist County,12041,2010,16939,15396,16094,845
2000, Florida,Gilchrist County,12041,2000,14437,13068,14033,404
2020, Florida,Jackson County,12063,2020,47319,31381,45104,2215
2000, Florida,Jackson County,12063,2000,46755,32811,45394,1361
2010, Florida,Lake County,12069,2010,297052,243624,261043,36009
2010, Florida,Jackson County,12063,2010,49746,34373,47603,2143
2000, Florida,Lake County,12069,2000,210528,184138,198720,11808
2000, Florida,Pasco County,12101,2000,344765,323036,325162,19603
2000, Florida,DeSoto County,12027,2000,32209,23619,24190,8019
2020, Florida,Pasco County,12101,2020,561891,417086,468734,93157
2000, Florida,Nassau County,12089,2000,57663,51909,56790,873
2020, Florida,Indian River County,12061,2020,159788,122541,138956,20832
2010, Florida,Indian River County,12061,2010,138028,116346,122563,15465
2020, Florida,Miami-Dade County,12086,2020,2701767,796893,844829,1856938
2020, Florida,Volusia County,12127,2020,553543,400163,470891,82652
2010, Florida,Glades County,12043,2010,12884,9153,10164,2720
2000, Florida,Glades County,12043,2000,10576,8142,8982,1594
2000, Florida,Sarasota County,12115,2000,325957,301985,311815,14142
2010, Florida,Sarasota County,12115,2010,379448,342090,349415,30033
2000, Florida,St. Johns County,12109,2000,123135,111955,119891,3244
2020, Florida,Lafayette County,12067,2020,8226,6363,7288,938
2010, Florida,Volusia County,12127,2010,494593,408256,439376,55217
2000, Florida,Indian River County,12061,2000,112947,98754,105566,7381
2010, Florida,Citrus County,12017,2010,141236,131350,134652,6584
2020, Florida,Broward County,12011,2020,1944375,776174,1335672,608703
2010, Florida,Broward County,12011,2010,1748066,1102231,1309819,438247
2000, Florida,Broward County,12011,2000,1623018,1145287,1351366,271652
2000, Florida,Citrus County,12017,2000,118085,112236,114944,3141
2010, Florida,Miami-Dade County,12086,2010,2496435,1841887,872576,1623859
2000, Florida,Miami-Dade County,12086,2000,2253362,1570558,961625,1291737
2020, Florida,Citrus County,12017,2020,153843,134596,144602,9241
2010, Florida,St. Johns County,12109,2010,190039,169794,180067,9972
2000, Florida,Volusia County,12127,2000,443343,381760,414232,29111
2010, Florida,Pasco County,12101,2010,464697,409784,410161,54536
2010, Florida,Dixie County,12029,2010,16422,14584,15910,512
2000, Florida,Bradford County,12007,2000,26088,19900,25466,622
2020, Florida,Bradford County,12007,2020,28303,20929,26953,1350
2010, Florida,Bradford County,12007,2010,28520,21801,27500,1020
2020, Florida,Nassau County,12089,2020,90352,77047,85903,4449
2010, Florida,Nassau County,12089,2010,73314,65809,70934,2380
2020, Florida,Santa Rosa County,12113,2020,188000,151133,176110,11890
2000, Florida,Santa Rosa County,12113,2000,117743,106822,114775,2968
2010, Florida,Santa Rosa County,12113,2010,151372,132920,144865,6507
2020, Florida,Dixie County,12029,2020,16759,14057,16071,688
2010, Florida,DeSoto County,12027,2010,34862,23094,24437,10425
2000, Florida,Dixie County,12029,2000,13827,12279,13578,249
2020, Florida,Putnam County,12107,2020,73321,52345,65505,7816
2000, Florida,Baker County,12003,2000,22259,18707,21840,419
2020, Florida,Sarasota County,12115,2020,434006,359053,390770,43236
2020, Florida,Baker County,12003,2020,28259,22565,27286,973
2000, Florida,Putnam County,12107,2000,70423,54868,66255,4168
2020, Florida,DeSoto County,12027,2020,33976,21320,23965,10011
2020, Florida,Brevard County,12009,2020,606612,448180,538705,67907
2000, Florida,Brevard County,12009,2000,476230,413411,454260,21970
2020, Florida,Lake County,12069,2020,383956,269452,318581,65375
2010, Florida,Brevard County,12009,2010,543376,450927,499433,43943
2010, Florida,Putnam County,12107,2010,74364,57468,67658,6706
2020, Georgia,Effingham County,13103,2020,64769,49132,61277,3492
2020, Georgia,Montgomery County,13209,2020,8610,5789,8039,571
2000, Georgia,Montgomery County,13209,2000,8270,5766,7999,271
2020, Georgia,Coffee County,13069,2020,43092,25437,37662,5430
2010, Georgia,Montgomery County,13209,2010,9123,6291,8643,480
2000, Georgia,Effingham County,13103,2000,37535,31776,37004,531
2010, Georgia,Warren County,13301,2010,5834,2152,5780,54
2010, Georgia,Crisp County,13081,2010,23439,12487,22691,748
2000, Georgia,Warren County,13301,2000,6336,2500,6285,51
2000, Georgia,Cook County,13075,2000,15771,10714,15286,485
2020, Georgia,Warren County,13301,2020,5215,1994,5162,53
2010, Georgia,Cook County,13075,2010,17212,11525,16188,1024
2020, Georgia,Morgan County,13211,2020,20097,14609,19385,712
2020, Georgia,Crisp County,13081,2020,20128,10007,19494,634
2000, Georgia,Crisp County,13081,2000,21996,11894,21614,382
2010, Georgia,Effingham County,13103,2010,52250,43182,50749,1501
2020, Georgia,Cook County,13075,2020,17229,10975,16095,1134
2000, Georgia,Crawford County,13079,2000,12495,9103,12194,301
2000, Georgia,Morgan County,13211,2000,15457,10772,15209,248
2020, Georgia,Oglethorpe County,13221,2020,14825,11072,13956,869
2010, Georgia,Crawford County,13079,2010,12630,9428,12329,301
2010, Georgia,Colquitt County,13071,2010,45498,29441,37735,7763
2000, Georgia,Colquitt County,13071,2000,42053,28503,37499,4554
2020, Georgia,Colquitt County,13071,2020,45898,27248,37189,8709
2020, Georgia,Randolph County,13243,2020,6425,2253,6282,143
2000, Georgia,Randolph County,13243,2000,7791,3034,7699,92
2020, Georgia,Emanuel County,13107,2020,22768,14026,21775,993
2000, Georgia,Emanuel County,13107,2000,21837,13909,21092,745
2010, Georgia,Emanuel County,13107,2010,22598,13928,21677,921
2010, Georgia,Oglethorpe County,13221,2010,14899,11662,14353,546
2000, Georgia,Columbia County,13073,2000,89288,73814,86975,2313
2010, Georgia,Columbia County,13073,2010,124053,94867,117878,6175
2020, Georgia,Columbia County,13073,2020,156010,102028,144152,11858
2020, Georgia,Crawford County,13079,2020,12130,9008,11715,415
2000, Georgia,Oglethorpe County,13221,2000,12635,9892,12461,174
2010, Georgia,Morgan County,13211,2010,17868,12984,17374,494
2010, Georgia,Randolph County,13243,2010,7719,2827,7600,119
2010, Georgia,Catoosa County,13047,2010,63942,59845,62473,1469
2000, Georgia,Coweta County,13077,2000,89215,70353,86418,2797
2000, Georgia,Washington County,13303,2000,21176,9683,21042,134
2020, Georgia,Washington County,13303,2020,19988,8482,19654,334
2020, Georgia,Elbert County,13105,2020,19637,12824,18641,996
2000, Georgia,Elbert County,13105,2000,20511,13730,20022,489
2010, Georgia,Elbert County,13105,2010,20166,13297,19199,967
2020, Georgia,Upson County,13293,2020,27700,18141,27067,633
2020, Georgia,Oconee County,13219,2020,41799,34450,39452,2347
2020, Georgia,Coweta County,13077,2020,146158,101755,135105,11053
2010, Georgia,Washington County,13303,2010,21187,9531,20780,407
2000, Georgia,Upson County,13293,2000,27597,19477,27270,327
2010, Georgia,Upson County,13293,2010,27153,18693,26565,588
2010, Georgia,Oconee County,13219,2010,32808,29004,31372,1436
2000, Georgia,Oconee County,13219,2000,26225,23492,25392,833
2020, Georgia,Catoosa County,13047,2020,67872,59903,65531,2341
2000, Georgia,Catoosa County,13047,2000,53282,51356,52661,621
2010, Georgia,Coweta County,13077,2010,127317,96594,118824,8493
2000, Georgia,Dodge County,13091,2000,19171,13219,18923,248
2010, Georgia,Coffee County,13069,2010,42356,27386,38004,4352
2020, Georgia,McIntosh County,13191,2020,10975,7145,10744,231
2010, Georgia,Wayne County,13305,2010,30099,22558,28380,1719
2000, Georgia,Wayne County,13305,2000,26565,20382,25552,1013
2010, Georgia,DeKalb County,13089,2010,691893,230156,624069,67824
2000, Georgia,DeKalb County,13089,2000,665865,238521,613323,52542
2020, Georgia,Wayne County,13305,2020,30144,21859,28412,1732
2020, Georgia,DeKalb County,13089,2020,764382,225752,682911,81471
2020, Georgia,McDuffie County,13189,2020,21632,11580,20842,790
2000, Georgia,Dawson County,13085,2000,15999,15554,15745,254
2010, Georgia,Dawson County,13085,2010,22330,21351,21410,920
2000, Georgia,McIntosh County,13191,2000,10847,6654,10748,99
2020, Georgia,Dawson County,13085,2020,26798,23852,25193,1605
2020, Georgia,Clarke County,13059,2020,128671,74925,114335,14336
2010, Georgia,Clarke County,13059,2010,116714,72238,104522,12192
2000, Georgia,Miller County,13201,2000,6383,4485,6339,44
2000, Georgia,McDuffie County,13189,2000,21231,12905,20947,284
2010, Georgia,McDuffie County,13189,2010,21875,12518,21400,475
2020, Georgia,Chattooga County,13055,2020,24965,20293,23668,1297
2010, Georgia,Miller County,13201,2010,6125,4266,6032,93
2020, Georgia,Miller County,13201,2020,6000,3986,5864,136
2000, Georgia,Muscogee County,13215,2000,186291,93936,177919,8372
2020, Georgia,Muscogee County,13215,2020,206922,82467,190409,16513
2000, Georgia,Clarke County,13059,2000,101489,65852,95053,6436
2010, Georgia,McIntosh County,13191,2010,14333,8811,14106,227
2020, Georgia,Decatur County,13087,2020,29367,14558,27456,1911
2000, Georgia,Decatur County,13087,2000,28240,16126,27335,905
2020, Georgia,Dodge County,13091,2020,19925,13020,19305,620
2000, Georgia,Schley County,13249,2000,3766,2477,3677,89
2010, Georgia,Schley County,13249,2010,5010,3658,4849,161
2020, Georgia,Schley County,13249,2020,4547,3425,4372,175
2020, Georgia,Newton County,13217,2020,112483,48030,105319,7164
2000, Georgia,Dooly County,13093,2000,11525,5298,10988,537
2020, Georgia,Dooly County,13093,2020,11208,4691,10411,797
2010, Georgia,Dooly County,13093,2010,14918,6810,14056,862
2010, Georgia,Newton County,13217,2010,99958,53754,95323,4635
2000, Georgia,Newton County,13217,2000,62001,46666,60844,1157
2020, Georgia,Dougherty County,13095,2020,85790,20976,83377,2413
2000, Georgia,Dougherty County,13095,2000,96065,36315,94773,1292
2010, Georgia,Dougherty County,13095,2010,94565,27986,92492,2073
2010, Georgia,Meriwether County,13199,2010,21992,12741,21645,347
2020, Georgia,Meriwether County,13199,2020,20613,12233,20138,475
2000, Georgia,Meriwether County,13199,2000,22534,12644,22343,191
2010, Georgia,Douglas County,13097,2010,132403,69458,121278,11125
2020, Georgia,Douglas County,13097,2020,144237,52285,128202,16035
2000, Georgia,Douglas County,13097,2000,92174,71235,89534,2640
2020, Georgia,Cherokee County,13057,2020,266620,204670,234509,32111
2000, Georgia,Cherokee County,13057,2000,141903,131128,134208,7695
2010, Georgia,Cherokee County,13057,2010,214346,185536,193780,20566
2010, Georgia,Decatur County,13087,2010,27842,15096,26438,1404
2000, Georgia,Chattooga County,13055,2000,25470,22084,24933,537
2020, Georgia,Jones County,13169,2020,28347,20206,27871,476
2010, Georgia,Chattooga County,13055,2010,26015,21828,24972,1043
2010, Georgia,Muscogee County,13215,2010,189885,87870,177775,12110
2000, Georgia,Clinch County,13065,2000,6878,4741,6824,54
2010, Georgia,Clinch County,13065,2010,6798,4581,6562,236
2010, Georgia,Dodge County,13091,2010,21796,14549,21064,732
2020, Georgia,Walton County,13297,2020,96673,69649,91445,5228
2000, Georgia,Walton County,13297,2000,60687,50387,59524,1163
2010, Georgia,Walton County,13297,2010,83768,67057,81085,2683
2000, Georgia,Early County,13099,2000,12354,6212,12202,152
2020, Georgia,Early County,13099,2020,10854,4864,10668,186
2010, Georgia,Early County,13099,2010,11008,5324,10837,171
2020, Georgia,Echols County,13101,2020,3697,2534,2606,1091
2020, Georgia,Clinch County,13065,2020,6749,4309,6496,253
2000, Georgia,Echols County,13101,2000,3754,2896,3015,739
2020, Georgia,Monroe County,13207,2020,27957,20122,27243,714
2020, Georgia,Cobb County,13067,2020,766149,387625,654909,111240
2000, Georgia,Cobb County,13067,2000,607751,439991,560787,46964
2010, Georgia,Cobb County,13067,2010,688078,428023,603748,84330
2000, Georgia,Monroe County,13207,2000,21757,15309,21476,281
2010, Georgia,Monroe County,13207,2010,26424,19365,25889,535
2010, Georgia,Ware County,13299,2010,36312,24103,35105,1207
2000, Georgia,Ware County,13299,2000,35483,24714,34795,688
2020, Georgia,Ware County,13299,2020,36251,22626,34639,1612
2000, Georgia,Coffee County,13069,2000,37413,25528,34863,2550
2010, Georgia,Echols County,13101,2010,4034,3023,2851,1183
2000, Georgia,Charlton County,13049,2000,10282,7052,10201,81
2020, Georgia,Charlton County,13049,2020,12518,8745,10482,2036
2000, Georgia,Mitchell County,13205,2000,23932,11864,23441,491
2010, Georgia,Clay County,13061,2010,3183,1197,3157,26
2020, Georgia,Clay County,13061,2020,2848,1151,2807,41
2000, Georgia,Clay County,13061,2000,3357,1290,3325,32
2010, Georgia,Chattahoochee County,13053,2010,11267,7753,9869,1398
2020, Georgia,Chattahoochee County,13053,2020,9565,5965,7955,1610
2010, Georgia,Walker County,13295,2010,68756,63918,67643,1113
2000, Georgia,Walker County,13295,2000,61053,57652,60488,565
2000, Georgia,Chatham County,13051,2000,232048,128279,226645,5403
2020, Georgia,Chatham County,13051,2020,295291,143891,271501,23790
2020, Georgia,Walker County,13295,2020,67654,60122,65969,1685
2020, Georgia,Murray County,13213,2020,39973,33343,34059,5914
2010, Georgia,Chatham County,13051,2010,265128,140010,250758,14370
2000, Georgia,Murray County,13213,2000,36506,34789,34500,2006
2010, Georgia,Murray County,13213,2010,39628,35320,34474,5154
2010, Georgia,Dade County,13083,2010,16633,15973,16341,292
2000, Georgia,Dade County,13083,2000,15154,14776,15017,137
2020, Georgia,Dade County,13083,2020,16251,14895,15887,364
2010, Georgia,Mitchell County,13205,2010,23498,11264,22470,1028
2020, Georgia,Mitchell County,13205,2020,21755,10273,20791,964
2010, Georgia,Clayton County,13063,2010,259424,48960,223977,35447
2010, Georgia,Charlton County,13049,2010,12171,8352,11861,310
2020, Georgia,Clayton County,13063,2020,297595,30505,255049,42546
2000, Georgia,Clayton County,13063,2000,236517,89741,218789,17728
2000, Georgia,Chattahoochee County,13053,2000,14882,8643,13331,1551
2020, Georgia,Johnson County,13167,2020,9189,5822,9072,117
2000, Georgia,White County,13311,2000,19944,18979,19633,311
2000, Georgia,Screven County,13251,2000,15374,8234,15227,147
2020, Georgia,Long County,13183,2020,16168,9197,14189,1979
2010, Georgia,Wilkes County,13317,2010,10593,5616,10232,361
2020, Georgia,Wilkes County,13317,2020,9565,5050,9166,399
2020, Georgia,Wilcox County,13315,2020,8766,5254,8494,272
2000, Georgia,Wilcox County,13315,2000,8577,5370,8438,139
2010, Georgia,Wilcox County,13315,2010,9255,5706,8917,338
2010, Georgia,Quitman County,13239,2010,2513,1290,2479,34
2000, Georgia,Brooks County,13027,2000,16450,9436,15945,505
2020, Georgia,Brooks County,13027,2020,16301,9307,15346,955
2000, Georgia,Wilkes County,13317,2000,10687,5891,10475,212
2010, Georgia,Brooks County,13027,2010,16243,9722,15390,853
2020, Georgia,Quitman County,13239,2020,2235,1190,2204,31
2000, Georgia,Jenkins County,13165,2000,8575,4827,8288,287
2020, Georgia,Rabun County,13241,2020,16883,15033,15431,1452
2010, Georgia,Rabun County,13241,2010,16276,15185,14975,1301
2020, Georgia,Lowndes County,13185,2020,118251,61186,110379,7872
2000, Georgia,Grady County,13131,2000,23659,15285,22437,1222
2020, Georgia,Grady County,13131,2020,26236,15065,22963,3273
2010, Georgia,Grady County,13131,2010,25011,15716,22511,2500
2000, Georgia,Lowndes County,13185,2000,92115,57112,89668,2447
2000, Georgia,Quitman County,13239,2000,2598,1354,2585,13
2010, Georgia,Long County,13183,2010,14464,9026,12686,1778
2000, Georgia,Long County,13183,2000,10304,7049,9434,870
2010, Georgia,Putnam County,13237,2010,21218,14408,19871,1347
2020, Georgia,Brantley County,13025,2020,18021,16427,17695,326
2010, Georgia,Polk County,13233,2010,41475,31974,36590,4885
2000, Georgia,Laurens County,13175,2000,44874,28469,44345,529
2020, Georgia,Laurens County,13175,2020,49570,28160,48146,1424
2000, Georgia,Barrow County,13013,2000,46144,39149,44684,1460
2000, Georgia,Greene County,13133,2000,14406,7628,13986,420
2020, Georgia,Greene County,13133,2020,18915,11296,17626,1289
2010, Georgia,Greene County,13133,2010,15994,9056,15101,893
2000, Georgia,Wilkinson County,13319,2000,10220,5924,10119,101
2010, Georgia,Barrow County,13013,2010,69367,54665,63330,6037
2010, Georgia,Jenkins County,13165,2010,8340,4579,8006,334
2020, Georgia,Jenkins County,13165,2020,8674,4679,8371,303
2010, Georgia,Thomas County,13275,2010,44720,26645,43445,1275
2020, Georgia,Tift County,13277,2020,41344,23237,36125,5219
2010, Georgia,Tift County,13277,2010,40118,24645,36081,4037
2020, Georgia,Wilkinson County,13319,2020,8877,5167,8638,239
2010, Georgia,Wilkinson County,13319,2010,9563,5598,9349,214
2020, Georgia,Barrow County,13013,2020,83505,57644,72945,10560
2000, Georgia,Polk County,13233,2000,38127,30700,35206,2921
2000, Georgia,Tift County,13277,2000,38407,25084,35463,2944
2020, Georgia,Polk County,13233,2020,42853,31249,37268,5585
2010, Georgia,Lowndes County,13185,2010,109233,63485,103995,5238
2010, Georgia,Brantley County,13025,2010,18411,17380,18068,343
2010, Georgia,Gordon County,13129,2010,55186,47032,47448,7738
2000, Georgia,Gordon County,13129,2000,44104,39557,40836,3268
2020, Georgia,Gilmer County,13123,2020,31353,26962,27754,3599
2010, Georgia,Bulloch County,13031,2010,70217,47215,67778,2439
2000, Georgia,Bulloch County,13031,2000,55983,38460,54931,1052
2020, Georgia,Bulloch County,13031,2020,81099,50718,76919,4180
2010, Georgia,Toombs County,13279,2010,27223,17728,24168,3055
2000, Georgia,Towns County,13281,2000,9319,9207,9252,67
2010, Georgia,Towns County,13281,2010,10471,10232,10265,206
2010, Georgia,Burke County,13033,2010,23316,11070,22699,617
2020, Georgia,Burke County,13033,2020,24596,12166,23819,777
2000, Georgia,Gilmer County,13123,2000,23456,21963,21641,1815
2000, Georgia,Burke County,13033,2000,22243,10433,21927,316
2020, Georgia,Peach County,13225,2020,27981,12499,25434,2547
2010, Georgia,Peach County,13225,2010,27695,13383,25805,1890
2000, Georgia,Lanier County,13173,2000,7241,5185,7115,126
2010, Georgia,Lanier County,13173,2010,10078,7118,9617,461
2020, Georgia,White County,13311,2020,28003,25261,27090,913
2000, Georgia,Paulding County,13223,2000,81678,73992,80280,1398
2020, Georgia,Paulding County,13223,2020,168661,111196,156097,12564
2010, Georgia,Paulding County,13223,2010,142324,110517,135060,7264
2020, Georgia,Towns County,13281,2020,12493,11594,12078,415
2000, Georgia,Peach County,13225,2000,23668,12135,22670,998
2010, Georgia,Gilmer County,13123,2010,28292,26115,25615,2677
2010, Georgia,Banks County,13011,2010,18395,16877,17354,1041
2010, Georgia,White County,13311,2010,27144,25824,26497,647
2000, Georgia,Banks County,13011,2000,14422,13435,13929,493
2020, Georgia,Banks County,13011,2020,18035,15838,16871,1164
2010, Georgia,Whitfield County,13313,2010,102599,78623,70128,32471
2010, Georgia,Bryan County,13029,2010,30233,24254,28897,1336
2000, Georgia,Bryan County,13029,2000,23417,19386,22952,465
2000, Georgia,Glynn County,13127,2000,67568,47746,65549,2019
2010, Georgia,Glynn County,13127,2010,79626,53823,74500,5126
2020, Georgia,Glynn County,13127,2020,84499,54229,78163,6336
2000, Georgia,Lumpkin County,13187,2000,21016,19760,20288,728
2010, Georgia,Lumpkin County,13187,2010,29966,28277,28622,1344
2020, Georgia,Lumpkin County,13187,2020,33488,29750,31698,1790
2000, Georgia,Whitfield County,13313,2000,83525,67602,65106,18419
2020, Georgia,Whitfield County,13313,2020,102864,65152,65948,36916
2020, Georgia,Rockdale County,13247,2020,93570,25661,84030,9540
2000, Georgia,Rockdale County,13247,2000,70111,53100,65929,4182
2010, Georgia,Rockdale County,13247,2010,85215,38187,77152,8063
2020, Georgia,Glascock County,13125,2020,2884,2590,2832,52
2010, Georgia,Glascock County,13125,2010,3082,2767,3049,33
2000, Georgia,Glascock County,13125,2000,2556,2316,2544,12
2020, Georgia,Toombs County,13279,2020,27030,16560,23986,3044
2000, Georgia,Toombs County,13279,2000,26067,18029,23757,2310
2020, Georgia,Gordon County,13129,2020,57544,45135,48587,8957
2000, Georgia,Brantley County,13025,2000,14629,13804,14477,152
2010, Georgia,Screven County,13251,2010,14593,7965,14413,180
2020, Georgia,Thomas County,13275,2020,45798,26375,44221,1577
2010, Georgia,Berrien County,13019,2010,19286,16327,18401,885
2020, Georgia,Berrien County,13019,2020,18160,14643,17115,1045
2000, Georgia,Haralson County,13143,2000,25690,23885,25547,143
2020, Georgia,Jefferson County,13163,2020,15709,6941,15247,462
2020, Georgia,Bibb County,13021,2020,157346,57778,150609,6737
2000, Georgia,Bibb County,13021,2000,153887,77147,151864,2023
2010, Georgia,Bibb County,13021,2010,155547,67199,151158,4389
2010, Georgia,Sumter County,13261,2010,32819,13852,31102,1717
2020, Georgia,Worth County,13321,2020,20784,14529,20403,381
2000, Georgia,Berrien County,13019,2000,16235,13877,15851,384
2010, Georgia,Hancock County,13141,2010,9429,2300,9290,139
2020, Georgia,Hancock County,13141,2020,8735,2421,8672,63
2020, Georgia,Tattnall County,13267,2020,22842,14276,20539,2303
2010, Georgia,Jefferson County,13163,2010,16930,7206,16413,517
2000, Georgia,Tattnall County,13267,2000,22305,13496,20422,1883
2010, Georgia,Tattnall County,13267,2010,25520,15991,23018,2502
2020, Georgia,Taylor County,13269,2020,7816,4640,7648,168
2000, Georgia,Taylor County,13269,2000,8815,4883,8652,163
2010, Georgia,Taylor County,13269,2010,8906,5208,8742,164
2010, Georgia,Spalding County,13255,2010,64073,40148,61622,2451
2000, Georgia,Hancock County,13141,2000,10076,2162,10022,54
2020, Georgia,Haralson County,13143,2020,29919,27011,29422,497
2010, Georgia,Haralson County,13143,2010,28780,26707,28462,318
2010, Georgia,Taliaferro County,13265,2010,1717,640,1682,35
2010, Georgia,Lee County,13177,2010,28298,21763,27738,560
2000, Georgia,Ben Hill County,13017,2000,17484,11059,16684,800
2010, Georgia,Ben Hill County,13017,2010,17634,10446,16608,1026
2020, Georgia,Ben Hill County,13017,2020,17194,9432,16140,1054
2020, Georgia,Lee County,13177,2020,33163,22985,32210,953
2020, Georgia,Heard County,13149,2020,11412,9672,11159,253
2000, Georgia,Heard County,13149,2000,11012,9633,10896,116
2010, Georgia,Heard County,13149,2010,11834,10284,11611,223
2020, Georgia,Hart County,13147,2020,25828,19447,24897,931
2000, Georgia,Hart County,13147,2000,22997,18188,22801,196
2010, Georgia,Hart County,13147,2010,25213,19515,24427,786
2010, Georgia,Harris County,13145,2010,32024,25392,31152,872
2000, Georgia,Harris County,13145,2000,23695,18584,23435,260
2020, Georgia,Harris County,13145,2020,34668,26353,33251,1417
2020, Georgia,Talbot County,13263,2020,5733,2461,5621,112
2010, Georgia,Talbot County,13263,2010,6865,2679,6774,91
2000, Georgia,Talbot County,13263,2000,6498,2391,6416,82
2000, Georgia,Taliaferro County,13265,2000,2077,793,2058,19
2020, Georgia,Taliaferro County,13265,2020,1559,606,1490,69
2000, Georgia,Sumter County,13261,2000,33200,16010,32309,891
2020, Georgia,Sumter County,13261,2020,29616,11783,27846,1770
2000, Georgia,Henry County,13151,2000,119341,97116,116649,2692
2010, Georgia,Pike County,13231,2010,17869,15606,17676,193
2020, Georgia,Pike County,13231,2020,18889,16439,18541,348
2000, Georgia,Pike County,13231,2000,13688,11448,13521,167
2010, Georgia,Habersham County,13137,2010,43041,36893,37708,5333
2010, Georgia,Pickens County,13227,2010,29431,28171,28612,819
2000, Georgia,Pickens County,13227,2000,22983,22111,22516,467
2020, Georgia,Pickens County,13227,2020,33216,30400,32018,1198
2020, Georgia,Spalding County,13255,2020,67306,37855,63640,3666
2020, Georgia,Gwinnett County,13135,2020,957062,339822,736602,220460
2010, Georgia,Gwinnett County,13135,2010,805321,429563,643286,162035
2020, Georgia,Jeff Davis County,13161,2020,14779,10354,12732,2047
2000, Georgia,Gwinnett County,13135,2000,588448,427883,524311,64137
2020, Georgia,Bartow County,13015,2020,108901,82391,98150,10751
2020, Georgia,Lincoln County,13181,2020,7690,5239,7598,92
2000, Georgia,Lincoln County,13181,2000,8348,5364,8267,81
2010, Georgia,Bartow County,13015,2010,100157,82862,92467,7690
2010, Georgia,Lincoln County,13181,2010,7996,5257,7898,98
2000, Georgia,Terrell County,13273,2000,10970,4163,10834,136
2020, Georgia,Terrell County,13273,2020,9185,3237,9008,177
2000, Georgia,Bartow County,13015,2000,76019,66734,73495,2524
2000, Georgia,Putnam County,13237,2000,18812,12689,18405,407
2010, Georgia,Laurens County,13175,2010,48434,29355,47291,1143
2010, Georgia,Terrell County,13273,2010,9315,3407,9158,157
2000, Georgia,Thomas County,13275,2000,42737,25207,42003,734
2020, Georgia,Habersham County,13137,2020,46031,36249,39151,6880
2020, Georgia,Lanier County,13173,2020,9877,6794,9305,572
2000, Georgia,Habersham County,13137,2000,35902,31910,33152,2750
2010, Georgia,Jeff Davis County,13161,2010,15068,11463,13491,1577
2000, Georgia,Jefferson County,13163,2000,17266,7267,17007,259
2000, Georgia,Pierce County,13229,2000,15636,13588,15279,357
2020, Georgia,Pierce County,13229,2020,19716,16654,18718,998
2010, Georgia,Henry County,13151,2010,203922,112201,192109,11813
2000, Georgia,Bleckley County,13023,2000,11666,8544,11559,107
2020, Georgia,Bleckley County,13023,2020,12583,9016,12114,469
2010, Georgia,Bleckley County,13023,2010,13063,9151,12762,301
2010, Georgia,Worth County,13321,2010,21679,15232,21344,335
2000, Georgia,Spalding County,13255,2000,58417,38846,57470,947
2000, Georgia,Worth County,13321,2000,21967,15090,21727,240
2020, Georgia,Henry County,13151,2020,240712,89241,222275,18437
2020, Georgia,Liberty County,13179,2020,65256,25953,57470,7786
2000, Georgia,Liberty County,13179,2000,61610,28737,56588,5022
2010, Georgia,Hall County,13139,2010,179684,133197,132778,46906
2010, Georgia,Pierce County,13229,2010,18758,16293,17871,887
2020, Georgia,Hall County,13139,2020,203136,130744,146126,57010
2000, Georgia,Hall County,13139,2000,139277,112470,112035,27242
2020, Georgia,Telfair County,13271,2020,12477,7269,10549,1928
2000, Georgia,Telfair County,13271,2000,11794,7042,11579,215
2010, Georgia,Liberty County,13179,2010,63453,29881,57294,6159
2010, Georgia,Telfair County,13271,2010,16500,9398,14474,2026
2000, Georgia,Jeff Davis County,13161,2000,12684,10300,12033,651
2000, Georgia,Baldwin County,13009,2000,44700,24215,44093,607
2020, Georgia,Bryan County,13029,2020,44738,32217,41469,3269
2020, Georgia,Baldwin County,13009,2020,43799,22655,42660,1139
2000, Georgia,Seminole County,13253,2000,9369,5785,9022,347
2020, Georgia,Seminole County,13253,2020,9147,5658,8919,228
2010, Georgia,Candler County,13043,2010,10998,7253,9771,1227
2020, Georgia,Candler County,13043,2020,10981,6768,9603,1378
2000, Georgia,Candler County,13043,2000,9577,6268,8695,882
2000, Georgia,Irwin County,13155,2000,9931,7148,9729,202
2020, Georgia,Irwin County,13155,2020,9666,6487,9003,663
2010, Georgia,Turner County,13287,2010,8930,4886,8648,282
2000, Georgia,Forsyth County,13117,2000,98407,93531,92930,5477
2010, Georgia,Forsyth County,13117,2010,175511,149946,158961,16550
2010, Georgia,Irwin County,13155,2010,9538,6811,9310,228
2000, Georgia,Marion County,13197,2000,7144,4347,6731,413
2000, Georgia,Twiggs County,13289,2000,10590,5812,10478,112
2020, Georgia,Twiggs County,13289,2020,8022,4522,7898,124
2010, Georgia,Pulaski County,13235,2010,12010,7679,11545,465
2000, Georgia,Pulaski County,13235,2000,9588,6041,9318,270
2000, Georgia,Rabun County,13241,2000,15050,14280,14367,683
2000, Georgia,Franklin County,13119,2000,20285,18153,20098,187
2010, Georgia,Franklin County,13119,2010,22084,19280,21218,866
2020, Georgia,Franklin County,13119,2020,23424,19449,22303,1121
2000, Georgia,Calhoun County,13037,2000,6320,2418,6131,189
2020, Georgia,Atkinson County,13003,2020,8286,5280,6238,2048
2020, Georgia,Fulton County,13121,2020,1066710,418700,980408,86302
2010, Georgia,Fulton County,13121,2010,920581,409697,848015,72566
2000, Georgia,Fulton County,13121,2000,816006,392598,767950,48056
2000, Georgia,Troup County,13285,2000,58779,38676,57775,1004
2020, Georgia,Troup County,13285,2020,69426,38639,66470,2956
2010, Georgia,Troup County,13285,2010,67044,41216,64874,2170
2000, Georgia,Turner County,13287,2000,9504,5357,9260,244
2020, Georgia,Turner County,13287,2020,9006,4812,8634,372
2020, Georgia,Camden County,13039,2020,54768,38371,51110,3658
2000, Georgia,Camden County,13039,2000,43664,32765,42079,1585
2010, Georgia,Camden County,13039,2010,50513,37557,47923,2590
2000, Georgia,Johnson County,13167,2000,8560,5345,8482,78
2010, Georgia,Stewart County,13259,2010,6058,1696,4604,1454
2000, Georgia,Stewart County,13259,2000,5252,1949,5173,79
2020, Georgia,Stewart County,13259,2020,5314,1352,4097,1217
2020, Georgia,Pulaski County,13235,2020,9855,6098,9528,327
2020, Georgia,Calhoun County,13037,2020,5573,1783,5424,149
2020, Georgia,Appling County,13001,2020,18444,13071,16619,1825
2010, Georgia,Twiggs County,13289,2010,9023,5123,8899,124
2020, Georgia,Stephens County,13257,2020,26784,21589,25927,857
2010, Georgia,Jasper County,13159,2010,13900,10271,13390,510
2000, Georgia,Jasper County,13159,2000,11426,8107,11190,236
2020, Georgia,Fayette County,13113,2020,119194,69788,109714,9480
2010, Georgia,Fayette County,13113,2010,106567,75802,99807,6760
2000, Georgia,Fayette County,13113,2000,91263,76541,88681,2582
2000, Georgia,Fannin County,13111,2000,19798,19398,19668,130
2010, Georgia,Stephens County,13257,2010,26175,22286,25542,633
2010, Georgia,Fannin County,13111,2010,23682,23007,23251,431
2010, Georgia,Jones County,13169,2010,28669,20989,28354,315
2000, Georgia,Jones County,13169,2000,23639,17735,23470,169
2020, Georgia,Jasper County,13159,2020,14588,10913,13904,684
2020, Georgia,Evans County,13109,2020,10774,6240,9537,1237
2000, Georgia,Evans County,13109,2000,10495,6474,9870,625
2010, Georgia,Evans County,13109,2010,11000,6471,9559,1441
2020, Georgia,Screven County,13251,2020,14067,8087,13780,287
2020, Georgia,Fannin County,13111,2020,25319,23549,24566,753
2000, Georgia,Stephens County,13257,2000,25435,21808,25185,250
2000, Georgia,Union County,13291,2000,17289,16932,17136,153
2010, Georgia,Union County,13291,2010,21356,20668,20837,519
2000, Georgia,Appling County,13001,2000,17419,13376,16627,792
2010, Georgia,Appling County,13001,2010,18236,13385,16532,1704
2010, Georgia,Marion County,13197,2010,8742,5254,8172,570
2020, Georgia,Marion County,13197,2020,7498,4551,6938,560
2010, Georgia,Floyd County,13115,2010,96317,74055,87330,8987
2000, Georgia,Floyd County,13115,2000,90565,73668,85582,4983
2010, Georgia,Jackson County,13157,2010,60485,52496,56749,3736
2020, Georgia,Jackson County,13157,2020,75907,60464,69195,6712
2000, Georgia,Jackson County,13157,2000,41589,37016,40340,1249
2020, Georgia,Floyd County,13115,2020,98584,69485,87118,11466
2010, Georgia,Webster County,13307,2010,2799,1512,2701,98
2000, Georgia,Webster County,13307,2000,2390,1207,2324,66
2010, Georgia,Carroll County,13045,2010,110527,83579,103727,6800
2000, Georgia,Carroll County,13045,2000,87268,70265,85025,2243
2020, Georgia,Carroll County,13045,2020,119148,82566,109562,9586
2010, Georgia,Seminole County,13253,2010,8729,5594,8525,204
2020, Georgia,Union County,13291,2020,24632,22836,23816,816
2020, Georgia,Webster County,13307,2020,2348,1145,2289,59
2010, Georgia,Calhoun County,13037,2010,6694,2326,6432,262
2020, Georgia,Forsyth County,13117,2020,251283,163687,226057,25226
2000, Georgia,Lee County,13177,2000,24757,20361,24457,300
2010, Georgia,Treutlen County,13283,2010,6885,4488,6782,103
2000, Georgia,Treutlen County,13283,2000,6854,4501,6775,79
2020, Georgia,Lamar County,13171,2020,18500,12475,18025,475
2010, Georgia,Macon County,13193,2010,14740,5177,14213,527
2010, Georgia,Richmond County,13245,2010,200549,79624,192342,8207
2020, Georgia,Richmond County,13245,2020,206607,70997,195158,11449
2010, Georgia,Wheeler County,13309,2010,7421,4552,7065,356
2020, Georgia,Putnam County,13237,2020,22047,14669,20490,1557
2000, Georgia,Richmond County,13245,2000,199775,91006,194230,5545
2010, Georgia,Baldwin County,13009,2010,45720,25121,44801,919
2000, Georgia,Baker County,13007,2000,4074,1932,3963,111
2020, Georgia,Baker County,13007,2020,2876,1536,2733,143
2010, Georgia,Baker County,13007,2010,3451,1675,3306,145
2010, Georgia,Lamar County,13171,2010,18317,12098,17976,341
2020, Georgia,Bacon County,13005,2020,11140,8251,10265,875
2010, Georgia,Bacon County,13005,2010,11096,8725,10305,791
2000, Georgia,Bacon County,13005,2000,10103,8232,9761,342
2020, Georgia,Treutlen County,13283,2020,6406,4106,6236,170
2020, Georgia,Butts County,13035,2020,25434,16823,24631,803
2000, Georgia,Lamar County,13171,2000,15912,10785,15740,172
2000, Georgia,Houston County,13153,2000,110765,78170,107402,3363
2020, Georgia,Wheeler County,13309,2020,7471,4226,7199,272
2000, Georgia,Macon County,13193,2000,14074,5260,13710,364
2010, Georgia,Houston County,13153,2010,139900,88626,131385,8515
2000, Georgia,Butts County,13035,2000,19522,13514,19245,277
2020, Georgia,Macon County,13193,2020,12082,4153,11610,472
2010, Georgia,Johnson County,13167,2010,9980,6301,9794,186
2000, Georgia,Wheeler County,13309,2000,6179,3989,5960,219
2010, Georgia,Butts County,13035,2010,23655,16546,23058,597
2010, Georgia,Atkinson County,13003,2010,8375,5213,6336,2039
2020, Georgia,Houston County,13153,2020,163633,88519,151826,11807
2020, Georgia,Madison County,13195,2020,30120,23977,28164,1956
2010, Georgia,Madison County,13195,2010,28120,24634,26981,1139
2000, Georgia,Atkinson County,13003,2000,7609,5082,6319,1290
2000, Georgia,Madison County,13195,2000,25730,22903,25223,507
2010, Hawaii,Kalawao County,15005,2010,90,24,89,1
2000, Hawaii,Maui County,15009,2000,128094,43421,118044,10050
2020, Hawaii,Kalawao County,15005,2020,82,27,64,18
2010, Hawaii,Maui County,15009,2010,154834,53336,139124,15710
2000, Hawaii,Honolulu County,15003,2000,876156,186484,817427,58729
2010, Hawaii,Honolulu County,15003,2010,953207,198732,875774,77433
2010, Hawaii,Kauai County,15007,2010,67091,22159,60776,6315
2000, Hawaii,Kalawao County,15005,2000,147,38,141,6
2020, Hawaii,Maui County,15009,2020,164754,54203,147840,16914
2020, Hawaii,Hawaii County,15001,2020,200629,67365,178354,22275
2010, Hawaii,Hawaii County,15001,2010,185079,62348,163696,21383
2000, Hawaii,Kauai County,15007,2000,58463,17255,53660,4803
2000, Hawaii,Hawaii County,15001,2000,148677,46904,134566,14111
2020, Hawaii,Kauai County,15007,2020,73298,23204,65904,7394
2020, Hawaii,Honolulu County,15003,2020,1016508,188462,924186,92322
2020, Idaho,Payette County,16075,2020,25386,20431,21118,4268
2010, Idaho,Cassia County,16031,2010,22952,18781,17228,5724
2000, Idaho,Jefferson County,16051,2000,19155,17406,17248,1907
2020, Idaho,Jefferson County,16051,2020,30891,27092,27635,3256
2020, Idaho,Blaine County,16013,2020,24272,18677,19251,5021
2010, Idaho,Jefferson County,16051,2010,26140,23844,23499,2641
2010, Idaho,Blaine County,16013,2010,21376,18157,17104,4272
2000, Idaho,Blaine County,16013,2000,18991,17231,16961,2030
2000, Idaho,Adams County,16003,2000,3476,3347,3422,54
2020, Idaho,Adams County,16003,2020,4379,4060,4227,152
2000, Idaho,Oneida County,16071,2000,4125,4022,4030,95
2000, Idaho,Cassia County,16031,2000,21416,18137,17403,4013
2020, Idaho,Bear Lake County,16007,2020,6372,6036,6164,208
2020, Idaho,Twin Falls County,16083,2020,90046,72215,74836,15210
2020, Idaho,Lemhi County,16059,2020,7974,7386,7679,295
2000, Idaho,Benewah County,16009,2000,9171,8131,9029,142
2010, Idaho,Benewah County,16009,2010,9285,8039,9050,235
2020, Idaho,Benewah County,16009,2020,9530,7853,9276,254
2020, Idaho,Gem County,16045,2020,19123,16623,17401,1722
2000, Idaho,Bear Lake County,16007,2000,6411,6261,6257,154
2010, Idaho,Minidoka County,16067,2010,20069,16091,13576,6493
2010, Idaho,Gem County,16045,2010,16719,15616,15383,1336
2000, Idaho,Gem County,16045,2000,15181,14238,14131,1050
2000, Idaho,Twin Falls County,16083,2000,64284,59445,58258,6026
2010, Idaho,Bear Lake County,16007,2010,5986,5767,5770,216
2020, Idaho,Valley County,16085,2020,11746,10597,11145,601
2020, Idaho,Cassia County,16031,2020,24655,17797,17469,7186
2000, Idaho,Lemhi County,16059,2000,7806,7543,7636,170
2000, Idaho,Clearwater County,16035,2000,8930,8467,8765,165
2010, Idaho,Payette County,16075,2010,22623,20053,19260,3363
2000, Idaho,Kootenai County,16055,2000,108685,104168,106157,2528
2020, Idaho,Lewis County,16061,2020,3533,3085,3395,138
2000, Idaho,Lewis County,16061,2000,3747,3455,3676,71
2010, Idaho,Lewis County,16061,2010,3821,3450,3693,128
2000, Idaho,Payette County,16075,2000,20578,18572,18125,2453
2020, Idaho,Nez Perce County,16069,2020,42090,36104,40460,1630
2010, Idaho,Nez Perce County,16069,2010,39265,35390,38156,1109
2010, Idaho,Valley County,16085,2010,9862,9445,9476,386
2000, Idaho,Nez Perce County,16069,2000,37410,34260,36689,721
2010, Idaho,Elmore County,16039,2010,27038,22213,22920,4118
2010, Idaho,Butte County,16023,2010,2891,2761,2772,119
2020, Idaho,Butte County,16023,2020,2574,2372,2440,134
2000, Idaho,Butte County,16023,2000,2899,2744,2779,120
2020, Idaho,Bingham County,16011,2020,47992,36630,39661,8331
2020, Idaho,Custer County,16037,2020,4275,3942,4119,156
2010, Idaho,Bingham County,16011,2010,45607,36752,37743,7864
2020, Idaho,Elmore County,16039,2020,28666,21488,23569,5097
2000, Idaho,Bingham County,16011,2000,41735,34403,36185,5550
2000, Idaho,Custer County,16037,2000,4342,4224,4159,183
2010, Idaho,Adams County,16003,2010,3976,3821,3882,94
2000, Idaho,Elmore County,16039,2000,29130,24869,25638,3492
2020, Idaho,Oneida County,16071,2020,4564,4313,4386,178
2010, Idaho,Oneida County,16071,2010,4286,4144,4160,126
2010, Idaho,Lemhi County,16059,2010,7936,7654,7755,181
2010, Idaho,Custer County,16037,2010,4368,4209,4192,176
2010, Idaho,Shoshone County,16079,2010,12765,12174,12385,380
2010, Idaho,Clearwater County,16035,2010,8761,8225,8493,268
2020, Idaho,Clearwater County,16035,2020,8734,7964,8434,300
2000, Idaho,Latah County,16057,2000,34935,32817,34195,740
2010, Idaho,Latah County,16057,2010,37244,34557,35918,1326
2020, Idaho,Minidoka County,16067,2020,21613,14591,13704,7909
2020, Idaho,Franklin County,16041,2020,14194,12908,13171,1023
2010, Idaho,Franklin County,16041,2010,12786,12064,11948,838
2000, Idaho,Washington County,16087,2000,9977,8741,8605,1372
2010, Idaho,Washington County,16087,2010,10198,8835,8482,1716
2020, Idaho,Washington County,16087,2020,10500,8571,8838,1662
2000, Idaho,Franklin County,16041,2000,11329,10775,10738,591
2000, Idaho,Gooding County,16047,2000,14155,12399,11741,2414
2010, Idaho,Bannock County,16005,2010,82839,74401,77252,5587
2000, Idaho,Bannock County,16005,2000,75565,68987,72025,3540
2020, Idaho,Gooding County,16047,2020,15598,11227,10751,4847
2020, Idaho,Kootenai County,16055,2020,171362,152438,162606,8756
2010, Idaho,Owyhee County,16073,2010,11526,8757,8547,2979
2000, Idaho,Teton County,16081,2000,5999,5478,5294,705
2000, Idaho,Minidoka County,16067,2000,20174,15749,15037,5137
2010, Idaho,Teton County,16081,2010,10170,8709,8449,1721
2020, Idaho,Owyhee County,16073,2020,11913,8686,8998,2915
2000, Idaho,Owyhee County,16073,2000,10644,8182,8185,2459
2010, Idaho,Kootenai County,16055,2010,138494,130844,133226,5268
2020, Idaho,Lincoln County,16063,2020,5127,3594,3488,1639
2010, Idaho,Lincoln County,16063,2010,5208,4171,3732,1476
2010, Idaho,Ada County,16001,2010,392365,354347,364460,27905
2000, Idaho,Lincoln County,16063,2000,4044,3497,3502,542
2010, Idaho,Gooding County,16047,2010,15464,12481,11120,4344
2020, Idaho,Clark County,16033,2020,790,498,502,288
2020, Idaho,Bannock County,16005,2020,87018,72902,79025,7993
2000, Idaho,Jerome County,16053,2000,18342,15955,15192,3150
2000, Idaho,Idaho County,16049,2000,15511,14599,15268,243
2010, Idaho,Idaho County,16049,2010,16267,15259,15846,421
2020, Idaho,Jerome County,16053,2020,24237,16412,15061,9176
2020, Idaho,Fremont County,16043,2020,13388,11563,11798,1590
2000, Idaho,Fremont County,16043,2000,11819,10804,10564,1255
2010, Idaho,Fremont County,16043,2010,13242,11855,11548,1694
2010, Idaho,Jerome County,16053,2010,22374,17904,15445,6929
2010, Idaho,Clark County,16033,2010,982,711,584,398
2010, Idaho,Power County,16077,2010,7817,5867,5489,2328
2020, Idaho,Latah County,16057,2020,39517,34294,37444,2073
2000, Idaho,Power County,16077,2000,7538,6315,5900,1638
2020, Idaho,Idaho County,16049,2020,16541,14819,15930,611
2020, Idaho,Ada County,16001,2020,494967,410263,449744,45223
2020, Idaho,Camas County,16025,2020,1077,948,1018,59
2000, Idaho,Camas County,16025,2000,991,943,936,55
2010, Idaho,Camas County,16025,2010,1117,1051,1042,75
2000, Idaho,Ada County,16001,2000,300904,279427,287437,13467
2000, Idaho,Clark County,16033,2000,1022,758,672,350
2020, Idaho,Power County,16077,2020,7878,5183,5254,2624
2010, Idaho,Canyon County,16027,2010,188923,156750,143854,45069
2020, Idaho,Teton County,16081,2020,11630,9413,9610,2020
2020, Idaho,Canyon County,16027,2020,231105,169392,171939,59166
2020, Idaho,Bonneville County,16019,2020,123964,103736,106870,17094
2010, Idaho,Bonneville County,16019,2010,104234,94411,92322,11912
2000, Idaho,Canyon County,16027,2000,131441,109225,106986,24455
2000, Idaho,Bonner County,16017,2000,36835,35574,36231,604
2010, Idaho,Bonner County,16017,2010,40877,39261,39966,911
2020, Idaho,Bonner County,16017,2020,47110,42939,45606,1504
2020, Idaho,Shoshone County,16079,2020,13169,11982,12719,450
2000, Idaho,Shoshone County,16079,2000,13771,13198,13505,266
2020, Idaho,Caribou County,16029,2020,7027,6504,6643,384
2000, Idaho,Caribou County,16029,2000,7304,7022,7015,289
2010, Idaho,Caribou County,16029,2010,6963,6637,6627,336
2010, Idaho,Twin Falls County,16083,2010,77230,68693,66660,10570
2000, Idaho,Valley County,16085,2000,7651,7378,7501,150
2010, Idaho,Boise County,16015,2010,7028,6703,6779,249
2020, Idaho,Boise County,16015,2020,7610,6844,7286,324
2010, Idaho,Madison County,16065,2010,37536,35235,35318,2218
2020, Idaho,Madison County,16065,2020,52913,45273,47665,5248
2000, Idaho,Bonneville County,16019,2000,82522,76574,76819,5703
2000, Idaho,Boise County,16015,2000,6670,6352,6442,228
2010, Idaho,Boundary County,16021,2010,10972,10398,10570,402
2020, Idaho,Boundary County,16021,2020,12056,10715,11364,692
2000, Idaho,Madison County,16065,2000,27467,26231,26389,1078
2000, Idaho,Boundary County,16021,2000,9871,9401,9536,335
2010, Illinois,Lake County,17097,2010,703462,528204,563475,139987
2000, Illinois,Warren County,17187,2000,18735,17910,18228,507
2020, Illinois,Lawrence County,17101,2020,15280,12885,14766,514
2000, Illinois,Montgomery County,17135,2000,30652,29083,30326,326
2010, Illinois,Montgomery County,17135,2010,30104,28632,29645,459
2010, Illinois,Kendall County,17093,2010,114736,95891,96838,17898
2020, Illinois,Monroe County,17133,2020,34962,32855,34316,646
2000, Illinois,Jasper County,17079,2000,10117,10031,10069,48
2000, Illinois,Jackson County,17077,2000,59612,48158,58169,1443
2010, Illinois,Jackson County,17077,2010,60218,46875,57815,2403
2020, Illinois,Jackson County,17077,2020,52974,38171,50137,2837
2020, Illinois,Crawford County,17033,2020,18679,17032,18232,447
2010, Illinois,Stephenson County,17177,2010,47711,41291,46305,1406
2010, Illinois,Henry County,17073,2010,50486,47846,48084,2402
2000, Illinois,Henry County,17073,2000,51020,49077,49553,1467
2020, Illinois,Henry County,17073,2020,49284,43920,46114,3170
2010, Illinois,LaSalle County,17099,2010,113924,106187,104789,9135
2000, Illinois,La Salle County,17099,2000,111509,105896,105718,5791
2000, Illinois,Iroquois County,17075,2000,31334,30059,30117,1217
2010, Illinois,Henderson County,17071,2010,7331,7198,7252,79
2010, Illinois,Lawrence County,17101,2010,16833,14696,16280,553
2020, Illinois,Montgomery County,17135,2020,28288,25872,27701,587
2000, Illinois,Crawford County,17033,2000,20452,19139,20101,351
2020, Illinois,Iroquois County,17075,2020,27077,24203,24992,2085
2000, Illinois,Monroe County,17133,2000,27619,27279,27416,203
2010, Illinois,Monroe County,17133,2010,32957,32287,32507,450
2020, Illinois,Kendall County,17093,2020,131869,90245,104742,27127
2000, Illinois,Stephenson County,17177,2000,48979,43733,48232,747
2000, Illinois,Lawrence County,17101,2000,15452,15139,15315,137
2000, Illinois,Lake County,17097,2000,644356,516189,551640,92716
2000, Illinois,Kendall County,17093,2000,54544,50658,50458,4086
2020, Illinois,Stephenson County,17177,2020,44630,35911,42376,2254
2020, Illinois,LaSalle County,17099,2020,109658,93847,98202,11456
2020, Illinois,Jasper County,17079,2020,9287,8968,9203,84
2020, Illinois,Lake County,17097,2020,714342,435395,542380,171962
2010, Illinois,Crawford County,17033,2010,19817,18381,19455,362
2020, Illinois,Warren County,17187,2020,16835,13842,15046,1789
2010, Illinois,Warren County,17187,2010,17707,16165,16217,1490
2020, Illinois,Henderson County,17071,2020,6387,6092,6275,112
2010, Illinois,Iroquois County,17075,2010,29718,28155,28134,1584
2000, Illinois,Henderson County,17071,2000,8213,8090,8141,72
2000, Illinois,Livingston County,17105,2000,39678,36629,38622,1056
2010, Illinois,Lee County,17103,2010,36031,32745,34229,1802
2000, Illinois,Gallatin County,17059,2000,6445,6340,6389,56
2010, Illinois,Fulton County,17057,2010,37069,34625,36173,896
2020, Illinois,Fulton County,17057,2020,33609,30803,32871,738
2000, Illinois,Fulton County,17057,2000,38250,36384,37772,478
2000, Illinois,McHenry County,17111,2000,260077,244240,240475,19602
2010, Illinois,McHenry County,17111,2010,308760,278257,273511,35249
2010, Illinois,Gallatin County,17059,2010,5589,5473,5523,66
2020, Illinois,McHenry County,17111,2020,310229,247894,263524,46705
2020, Illinois,DuPage County,17043,2020,932877,616830,788586,144291
2000, Illinois,DuPage County,17043,2000,904161,759924,822795,81366
2010, Illinois,McDonough County,17109,2010,32612,29476,31745,867
2020, Illinois,McDonough County,17109,2020,27238,23330,26276,962
2000, Illinois,McDonough County,17109,2000,32913,30568,32425,488
2010, Illinois,Franklin County,17055,2010,39561,38641,39086,475
2010, Illinois,DuPage County,17043,2010,916924,714140,795418,121506
2000, Illinois,McLean County,17113,2000,150433,134170,146600,3833
2020, Illinois,Gallatin County,17059,2020,4946,4700,4893,53
2010, Illinois,Madison County,17119,2010,269282,237641,261969,7313
2010, Illinois,Macon County,17115,2010,110768,87855,108696,2072
2020, Illinois,Macon County,17115,2020,103998,75809,101265,2733
2020, Illinois,Macoupin County,17117,2020,44967,42082,44397,570
2000, Illinois,Macoupin County,17117,2000,49019,48034,48714,305
2010, Illinois,Macoupin County,17117,2010,47765,46596,47347,418
2020, Illinois,Schuyler County,17169,2020,6902,6211,6750,152
2010, Illinois,Schuyler County,17169,2010,7544,7205,7454,90
2020, Illinois,Madison County,17119,2020,265859,216458,255062,10797
2020, Illinois,Douglas County,17041,2020,19740,17855,18175,1565
2010, Illinois,Douglas County,17041,2010,19980,19113,18770,1210
2000, Illinois,Douglas County,17041,2000,19922,19375,19232,690
2000, Illinois,Schuyler County,17169,2000,7189,7103,7150,39
2010, Illinois,McLean County,17113,2010,169572,142940,162138,7434
2020, Illinois,McLean County,17113,2020,170954,132148,160430,10524
2000, Illinois,Madison County,17119,2000,258941,233645,255016,3925
2000, Illinois,Franklin County,17055,2000,39018,38485,38769,249
2020, Illinois,Franklin County,17055,2020,37804,35451,37162,642
2000, Illinois,Scott County,17171,2000,5537,5507,5527,10
2010, Illinois,Scott County,17171,2010,5355,5279,5312,43
2000, Illinois,Marion County,17121,2000,41691,39209,41313,378
2010, Illinois,Marion County,17121,2010,39437,36734,38895,542
2020, Illinois,Marion County,17121,2020,37729,33440,37017,712
2000, Illinois,Union County,17181,2000,18293,17612,17812,481
2000, Illinois,Mason County,17125,2000,16038,15849,15958,80
2010, Illinois,Mason County,17125,2010,14666,14382,14549,117
2020, Illinois,Union County,17181,2020,17244,15513,16377,867
2010, Illinois,Union County,17181,2010,17808,16880,16945,863
2020, Illinois,Fayette County,17051,2020,21488,19778,20831,657
2000, Illinois,Fayette County,17051,2000,21802,20499,21628,174
2010, Illinois,Fayette County,17051,2010,22140,20750,21836,304
2020, Illinois,Marshall County,17123,2020,11742,10965,11419,323
2010, Illinois,Marshall County,17123,2010,12640,12271,12326,314
2020, Illinois,Mason County,17125,2020,13086,12423,12902,184
2000, Illinois,Marshall County,17123,2000,13180,12941,13042,138
2010, Illinois,Effingham County,17049,2010,34242,33429,33645,597
2000, Illinois,Vermilion County,17183,2000,83919,72032,81415,2504
2020, Illinois,Effingham County,17049,2020,34668,32597,33796,872
2000, Illinois,Edwards County,17047,2000,6971,6892,6939,32
2020, Illinois,Scott County,17171,2020,4949,4765,4901,48
2020, Illinois,Johnson County,17087,2020,13308,10978,12756,552
2000, Illinois,Johnson County,17087,2000,12878,10756,12510,368
2010, Illinois,Johnson County,17087,2010,12582,11197,12206,376
2000, Illinois,Ford County,17053,2000,14241,13982,14065,176
2010, Illinois,Ford County,17053,2010,14081,13677,13787,294
2020, Illinois,Ford County,17053,2020,13534,12458,12980,554
2010, Illinois,Edgar County,17045,2010,18576,18268,18389,187
2000, Illinois,Edgar County,17045,2000,19704,19137,19550,154
2020, Illinois,Edgar County,17045,2020,16866,16070,16641,225
2010, Illinois,Massac County,17127,2010,15429,14033,15139,290
2020, Illinois,Massac County,17127,2020,14169,12179,13836,333
2000, Illinois,Massac County,17127,2000,15161,14034,15038,123
2010, Illinois,Edwards County,17047,2010,6721,6584,6662,59
2020, Illinois,Edwards County,17047,2020,6245,6019,6182,63
2000, Illinois,Effingham County,17049,2000,34264,33804,34012,252
2000, Illinois,Lee County,17103,2000,36062,33422,34915,1147
2020, Illinois,Vermilion County,17183,2020,74188,57282,70372,3816
2000, Illinois,Macon County,17115,2000,114706,95760,113586,1120
2020, Illinois,Sangamon County,17167,2020,196343,151998,191034,5309
2000, Illinois,Jefferson County,17081,2000,40045,35990,39514,531
2020, Illinois,Jefferson County,17081,2020,37113,31440,36214,899
2010, Illinois,Tazewell County,17179,2010,135394,130225,132880,2514
2000, Illinois,Tazewell County,17179,2000,128485,125142,127154,1331
2020, Illinois,Tazewell County,17179,2020,131343,121078,128182,3161
2000, Illinois,Kane County,17089,2000,404119,320340,308195,95924
2000, Illinois,Sangamon County,17167,2000,188951,165179,186951,2000
2010, Illinois,Knox County,17095,2010,52919,46329,50361,2558
2000, Illinois,Knox County,17095,2000,55836,50175,53940,1896
2020, Illinois,Knox County,17095,2020,49967,40664,46916,3051
2000, Illinois,St. Clair County,17163,2000,256082,173970,250478,5604
2010, Illinois,St. Clair County,17163,2010,270056,174458,261271,8785
2010, Illinois,Stark County,17175,2010,5994,5855,5935,59
2010, Illinois,Sangamon County,17167,2010,197465,165103,193985,3480
2000, Illinois,Hamilton County,17065,2000,8621,8470,8566,55
2020, Illinois,Hamilton County,17065,2020,7993,7601,7897,96
2010, Illinois,Hamilton County,17065,2010,8457,8305,8352,105
2020, Illinois,Lee County,17103,2020,34145,29109,31821,2324
2010, Illinois,Cumberland County,17035,2010,11048,10856,10973,75
2000, Illinois,Cumberland County,17035,2000,11253,11123,11185,68
2020, Illinois,Cumberland County,17035,2020,10450,9984,10338,112
2010, Illinois,Hardin County,17069,2010,4320,4205,4264,56
2000, Illinois,Hardin County,17069,2000,4800,4580,4749,51
2000, Illinois,Hancock County,17067,2000,20121,19855,20016,105
2010, Illinois,Hancock County,17067,2010,19104,18723,18919,185
2020, Illinois,Hancock County,17067,2020,17620,16683,17302,318
2010, Illinois,Kankakee County,17091,2010,113449,87986,103282,10167
2000, Illinois,Kankakee County,17091,2000,103833,82954,98874,4959
2020, Illinois,Kankakee County,17091,2020,107502,76327,94982,12520
2010, Illinois,Kane County,17089,2010,515269,384548,356879,158390
2020, Illinois,Kane County,17089,2020,516522,309835,346927,169595
2010, Illinois,Jefferson County,17081,2010,38827,34315,38028,799
2000, Illinois,Stark County,17175,2000,6332,6245,6278,54
2020, Illinois,Stark County,17175,2020,5400,5129,5268,132
2020, Illinois,St. Clair County,17163,2020,257400,153376,244818,12582
2020, Illinois,Grundy County,17063,2020,52533,45106,46821,5712
2010, Illinois,Jersey County,17083,2010,22985,22431,22763,222
2000, Illinois,Wabash County,17185,2000,12937,12660,12842,95
2010, Illinois,Wabash County,17185,2010,11947,11576,11789,158
2020, Illinois,Wabash County,17185,2020,11361,10581,11183,178
2020, Illinois,Mercer County,17131,2020,15699,14763,15231,468
2010, Illinois,Mercer County,17131,2010,16434,16153,16127,307
2000, Illinois,Mercer County,17131,2000,16957,16680,16741,216
2020, Illinois,Menard County,17129,2020,12297,11555,12137,160
2000, Illinois,Menard County,17129,2000,12486,12310,12392,94
2010, Illinois,Menard County,17129,2010,12705,12383,12584,121
2020, Illinois,Jersey County,17083,2020,21512,20209,21185,327
2000, Illinois,Jersey County,17083,2000,21668,21263,21506,162
2010, Illinois,Jo Daviess County,17085,2010,22678,22046,22069,609
2020, Illinois,Jo Daviess County,17085,2020,22035,20574,21179,856
2000, Illinois,Jo Daviess County,17085,2000,22289,21991,21947,342
2020, Illinois,Shelby County,17173,2020,20990,20197,20777,213
2010, Illinois,Vermilion County,17183,2010,81625,67323,78184,3441
2010, Illinois,Shelby County,17173,2010,22363,22045,22183,180
2010, Illinois,Logan County,17107,2010,30305,27008,29412,893
2010, Illinois,Grundy County,17063,2010,50063,46933,45967,4096
2000, Illinois,Grundy County,17063,2000,37535,36442,35983,1552
2020, Illinois,Livingston County,17105,2020,35815,32068,33956,1859
2010, Illinois,Livingston County,17105,2010,38950,35752,37418,1532
2000, Illinois,Greene County,17061,2000,14761,14475,14684,77
2010, Illinois,Greene County,17061,2010,13886,13588,13771,115
2020, Illinois,De Witt County,17039,2020,15516,14526,15006,510
2010, Illinois,De Witt County,17039,2010,16561,16035,16207,354
2000, Illinois,De Witt County,17039,2000,16798,16430,16585,213
2020, Illinois,Greene County,17061,2020,11985,11492,11879,106
2000, Illinois,DeKalb County,17037,2000,88969,78704,83139,5830
2010, Illinois,DeKalb County,17037,2010,105160,89453,94513,10647
2020, Illinois,DeKalb County,17037,2020,100420,74258,86823,13597
2020, Illinois,Logan County,17107,2020,27987,24669,27169,818
2000, Illinois,Logan County,17107,2000,31183,28593,30680,503
2000, Illinois,Shelby County,17173,2000,22893,22651,22783,110
2010, Illinois,Jasper County,17079,2010,9698,9564,9619,79
2020, Illinois,Hardin County,17069,2020,3649,3414,3584,65
2010, Illinois,Carroll County,17015,2010,15387,14906,14950,437
2010, Illinois,Richland County,17159,2010,16233,15795,16028,205
2010, Illinois,Bureau County,17011,2010,34978,32937,32283,2695
2020, Illinois,Bureau County,17011,2020,33244,29358,30149,3095
2000, Illinois,Ogle County,17141,2000,51032,48659,47966,3066
2010, Illinois,Ogle County,17141,2010,53497,49867,48756,4741
2020, Illinois,Ogle County,17141,2020,51788,44519,45991,5797
2000, Illinois,Bureau County,17011,2000,35503,34365,33771,1732
2000, Illinois,White County,17193,2000,15371,15097,15268,103
2020, Illinois,White County,17193,2020,13877,13062,13689,188
2000, Illinois,Richland County,17159,2000,16149,15852,16025,124
2010, Illinois,White County,17193,2010,14665,14393,14507,158
2000, Illinois,Whiteside County,17195,2000,60653,56294,55306,5347
2020, Illinois,Clay County,17025,2020,13288,12524,13065,223
2000, Illinois,Clay County,17025,2000,14560,14345,14472,88
2010, Illinois,Clay County,17025,2010,13815,13499,13664,151
2010, Illinois,Whiteside County,17195,2010,58498,53923,52043,6455
2020, Illinois,Whiteside County,17195,2020,55691,47759,48560,7131
2020, Illinois,Peoria County,17143,2020,181830,122629,171739,10091
2010, Illinois,Peoria County,17143,2010,186494,138800,179392,7102
2000, Illinois,Peoria County,17143,2000,183433,145602,179606,3827
2010, Illinois,Winnebago County,17201,2010,295266,228652,263089,32177
2020, Illinois,Richland County,17159,2020,15813,14896,15540,273
2020, Illinois,Moultrie County,17139,2020,14526,13815,14332,194
2000, Illinois,Moultrie County,17139,2000,14287,14131,14219,68
2000, Illinois,Coles County,17029,2000,53196,50734,52459,737
2010, Illinois,Washington County,17189,2010,14716,14376,14519,197
2000, Illinois,Washington County,17189,2000,15148,14933,15040,108
2010, Illinois,Morgan County,17137,2010,35547,32321,34835,712
2000, Illinois,Morgan County,17137,2000,36616,33811,36120,496
2020, Illinois,Cass County,17017,2020,13042,9528,10253,2789
2000, Illinois,Cass County,17017,2000,13695,13000,12533,1162
2010, Illinois,Cass County,17017,2010,13642,11769,11351,2291
2010, Illinois,Putnam County,17155,2010,6006,5803,5754,252
2020, Illinois,Putnam County,17155,2020,5637,5175,5289,348
2000, Illinois,Putnam County,17155,2000,6086,5941,5915,171
2020, Illinois,Calhoun County,17013,2020,4437,4227,4373,64
2000, Illinois,Calhoun County,17013,2000,5084,5023,5052,32
2010, Illinois,Calhoun County,17013,2010,5089,5032,5049,40
2010, Illinois,Clinton County,17027,2010,37762,35284,36704,1058
2000, Illinois,Clinton County,17027,2000,35535,33470,34965,570
2020, Illinois,Clinton County,17027,2020,36899,33085,35512,1387
2010, Illinois,Moultrie County,17139,2010,14846,14622,14717,129
2010, Illinois,Pulaski County,17153,2010,6161,3965,6064,97
2000, Illinois,Pulaski County,17153,2000,7348,4888,7241,107
2020, Illinois,Pulaski County,17153,2020,5193,3261,4989,204
2020, Illinois,Rock Island County,17161,2020,144672,102939,124830,19842
2020, Illinois,Coles County,17029,2020,46863,40838,45095,1768
2010, Illinois,Rock Island County,17161,2010,147546,120382,130428,17118
2010, Illinois,Pope County,17151,2010,4470,4098,4406,64
2020, Illinois,Woodford County,17203,2020,38467,36102,37727,740
2010, Illinois,Williamson County,17199,2010,66357,61542,65056,1301
2000, Illinois,Williamson County,17199,2000,61296,58441,60533,763
2020, Illinois,Piatt County,17147,2020,16673,15692,16426,247
2020, Illinois,Williamson County,17199,2020,67153,58897,65374,1779
2010, Illinois,Piatt County,17147,2010,16729,16393,16562,167
2000, Illinois,Piatt County,17147,2000,16365,16173,16264,101
2010, Illinois,Pike County,17149,2010,16430,15928,16258,172
2020, Illinois,Pike County,17149,2020,14739,13969,14477,262
2010, Illinois,Woodford County,17203,2010,38664,37643,38137,527
2000, Illinois,Pike County,17149,2000,17384,16929,17297,87
2000, Illinois,Boone County,17007,2000,41786,37643,36567,5219
2020, Illinois,Boone County,17007,2020,53448,38766,40568,12880
2000, Illinois,Bond County,17005,2000,17633,16000,17380,253
2010, Illinois,Bond County,17005,2010,17768,16143,17221,547
2000, Illinois,Saline County,17165,2000,26733,25166,26475,258
2020, Illinois,Bond County,17005,2020,16725,14446,16121,604
2020, Illinois,Winnebago County,17201,2020,285350,191124,244398,40952
2010, Illinois,Saline County,17165,2010,24913,23178,24573,340
2000, Illinois,Winnebago County,17201,2000,278418,229595,259212,19206
2010, Illinois,Boone County,17007,2010,54165,45724,43198,10967
2020, Illinois,Wayne County,17191,2020,16179,15458,15997,182
2000, Illinois,Wayne County,17191,2000,17151,16930,17048,103
2010, Illinois,Will County,17197,2010,677560,514664,571743,105817
2000, Illinois,Pope County,17151,2000,4413,4117,4373,40
2020, Illinois,Pope County,17151,2020,3763,3513,3692,71
2010, Illinois,Clark County,17023,2010,16335,16027,16163,172
2000, Illinois,Clark County,17023,2000,17008,16801,16954,54
2020, Illinois,Clark County,17023,2020,15455,14784,15209,246
2000, Illinois,Champaign County,17019,2000,179669,141536,174466,5203
2020, Illinois,Champaign County,17019,2020,205865,129083,189199,16666
2010, Illinois,Champaign County,17019,2010,201081,147600,190474,10607
2000, Illinois,Brown County,17009,2000,6950,5580,6677,273
2010, Illinois,Brown County,17009,2010,6937,5276,6535,402
2020, Illinois,Brown County,17009,2020,6244,4779,5962,282
2000, Illinois,Perry County,17145,2000,23094,20681,22688,406
2010, Illinois,Perry County,17145,2010,22350,19656,21751,599
2020, Illinois,Perry County,17145,2020,20945,17919,20231,714
2010, Illinois,Christian County,17021,2010,34800,33610,34329,471
2020, Illinois,Christian County,17021,2020,34032,31437,32938,1094
2000, Illinois,Christian County,17021,2000,35372,34077,35027,345
2010, Illinois,Wayne County,17191,2010,16760,16427,16584,176
2000, Illinois,Woodford County,17203,2000,35469,34928,35228,241
2020, Illinois,Will County,17197,2020,696355,443562,565504,130851
2000, Illinois,Will County,17197,2000,502266,411027,458498,43768
2000, Illinois,Rock Island County,17161,2000,149374,127742,136583,12791
2010, Illinois,Coles County,17029,2010,53873,50029,52718,1155
2020, Illinois,Saline County,17165,2020,23768,21481,23295,473
2000, Illinois,Randolph County,17157,2000,33893,30068,33372,521
2010, Illinois,Alexander County,17003,2010,8238,5018,8083,155
2000, Illinois,Cook County,17031,2000,5376741,3025760,4305001,1071740
2020, Illinois,Cook County,17031,2020,5275541,2345983,3892763,1382778
2010, Illinois,Adams County,17001,2010,67103,62868,66327,776
2020, Illinois,Alexander County,17003,2020,5240,3311,5158,82
2010, Illinois,Cook County,17031,2010,5194675,2877212,3949913,1244762
2000, Illinois,Alexander County,17003,2000,9590,6040,9452,138
2020, Illinois,Washington County,17189,2020,13761,13028,13537,224
2000, Illinois,Adams County,17001,2000,68277,64932,67710,567
2020, Illinois,Adams County,17001,2020,65737,58837,64450,1287
2020, Illinois,Randolph County,17157,2020,30163,25626,29132,1031
2020, Illinois,Morgan County,17137,2020,32915,28786,32077,838
2010, Illinois,Randolph County,17157,2010,33476,29318,32609,867
2020, Illinois,Carroll County,17015,2020,15702,14117,14945,757
2000, Illinois,Carroll County,17015,2000,16674,16164,16334,340
2010, Indiana,Wabash County,18169,2010,32888,31764,32191,697
2010, Indiana,Dearborn County,18029,2010,50047,48780,49545,502
2020, Indiana,Warrick County,18173,2020,63898,57756,62515,1383
2020, Indiana,Floyd County,18043,2020,80484,68660,77402,3082
2010, Indiana,Perry County,18123,2010,19338,18557,19146,192
2020, Indiana,Scott County,18143,2020,24384,23039,23849,535
2000, Indiana,Perry County,18123,2000,18899,18447,18766,133
2020, Indiana,Perry County,18123,2020,19170,17915,18950,220
2010, Indiana,Delaware County,18035,2010,117671,104872,115583,2088
2000, Indiana,Delaware County,18035,2000,118769,107763,117465,1304
2010, Indiana,Bartholomew County,18005,2010,76794,68824,72032,4762
2020, Indiana,Bartholomew County,18005,2020,82208,65763,74951,7257
2000, Indiana,Bartholomew County,18005,2000,71435,67271,69837,1598
2010, Indiana,Scott County,18143,2010,24181,23667,23827,354
2020, Indiana,Dearborn County,18029,2020,50679,47563,49955,724
2000, Indiana,Dearborn County,18029,2000,46109,45216,45843,266
2010, Indiana,Tipton County,18159,2010,15936,15551,15590,346
2010, Indiana,Randolph County,18135,2010,26171,25158,25381,790
2020, Indiana,Wabash County,18169,2020,30976,28937,30079,897
2000, Indiana,Wabash County,18169,2000,34960,34045,34546,414
2000, Indiana,Lawrence County,18093,2000,45922,44969,45506,416
2010, Indiana,Grant County,18053,2010,70061,61811,67544,2517
2000, Indiana,Scott County,18143,2000,22960,22648,22738,222
2020, Indiana,Grant County,18053,2020,66674,55610,63262,3412
2020, Indiana,Lawrence County,18093,2020,45011,42528,44246,765
2000, Indiana,Randolph County,18135,2000,27401,26869,27068,333
2010, Indiana,Lawrence County,18093,2010,46134,44905,45589,545
2000, Indiana,Grant County,18053,2000,73403,65495,71616,1787
2010, Indiana,Floyd County,18043,2010,74578,67408,72606,1972
2020, Indiana,Decatur County,18031,2020,26472,24961,25858,614
2010, Indiana,Decatur County,18031,2010,25740,25053,25314,426
2000, Indiana,Decatur County,18031,2000,24555,24186,24423,132
2020, Indiana,Randolph County,18135,2020,24502,22601,23346,1156
2020, Indiana,Warren County,18171,2020,8440,8064,8247,193
2010, Indiana,Brown County,18013,2010,15242,14874,15064,178
2020, Indiana,Shelby County,18145,2020,45055,40877,42678,2377
2020, Indiana,Posey County,18129,2020,25222,23775,24847,375
2000, Indiana,Posey County,18129,2000,27061,26511,26943,118
2010, Indiana,Posey County,18129,2010,25910,25185,25662,248
2010, Indiana,Howard County,18067,2010,82752,73284,80549,2203
2020, Indiana,Howard County,18067,2020,83658,69540,80598,3060
2000, Indiana,Howard County,18067,2000,84964,76235,83255,1709
2020, Indiana,Montgomery County,18107,2020,37936,34268,35655,2281
2010, Indiana,Warren County,18171,2010,8508,8363,8438,70
2020, Indiana,Rush County,18139,2020,16752,15952,16500,252
2000, Indiana,Rush County,18139,2000,18261,17840,18169,92
2010, Indiana,Whitley County,18183,2010,33292,32479,32777,515
2020, Indiana,Whitley County,18183,2020,34191,32126,33350,841
2000, Indiana,Whitley County,18183,2000,30707,30205,30431,276
2010, Indiana,Lake County,18089,2010,496005,319412,413342,82663
2000, Indiana,Daviess County,18027,2000,29820,29080,29200,620
2010, Indiana,Daviess County,18027,2010,31648,30077,30334,1314
2010, Indiana,Rush County,18139,2010,17392,16945,17202,190
2000, Indiana,Floyd County,18043,2000,70823,66026,70051,772
2020, Indiana,Porter County,18127,2020,173215,143005,154311,18904
2000, Indiana,Fayette County,18041,2000,25588,24862,25456,132
2020, Indiana,Brown County,18013,2020,15475,14565,15205,270
2020, Indiana,Delaware County,18035,2020,111903,94312,108370,3533
2020, Indiana,DeKalb County,18033,2020,43265,40666,42080,1185
2000, Indiana,DeKalb County,18033,2000,40285,39381,39609,676
2010, Indiana,DeKalb County,18033,2010,42223,40931,41192,1031
2000, Indiana,Brown County,18013,2000,14957,14682,14826,131
2010, Indiana,Clark County,18019,2010,110232,95961,104882,5350
2000, Indiana,Porter County,18127,2000,146798,139946,139719,7079
2020, Indiana,Fayette County,18041,2020,23398,22089,23125,273
2000, Indiana,Clark County,18019,2000,96472,87110,94673,1799
2000, Indiana,Shelby County,18145,2000,43445,42254,42948,497
2010, Indiana,Shelby County,18145,2010,44436,42402,42789,1647
2000, Indiana,Sullivan County,18153,2000,21751,20470,21572,179
2010, Indiana,Sullivan County,18153,2010,21475,20132,21181,294
2020, Indiana,Sullivan County,18153,2020,20817,18960,20483,334
2010, Indiana,Fayette County,18041,2010,24277,23532,24054,223
2020, Indiana,Clark County,18019,2020,121093,97115,113202,7891
2000, Indiana,Tipton County,18159,2000,16577,16303,16376,201
2010, Indiana,Miami County,18103,2010,36903,33876,35997,906
2000, Indiana,Tippecanoe County,18157,2000,148955,132354,141121,7834
2020, Indiana,Newton County,18111,2020,13830,12322,12791,1039
2010, Indiana,Pike County,18125,2010,12845,12610,12725,120
2000, Indiana,Pike County,18125,2000,12837,12722,12763,74
2000, Indiana,Hancock County,18059,2000,55391,54527,54865,526
2020, Indiana,Hancock County,18059,2020,79840,71721,77638,2202
2010, Indiana,Hancock County,18059,2010,70002,66644,68786,1216
2020, Indiana,Noble County,18113,2020,47457,41352,42207,5250
2000, Indiana,Noble County,18113,2000,46275,43490,42976,3299
2010, Indiana,Vermillion County,18165,2010,16212,15932,16082,130
2000, Indiana,Vermillion County,18165,2000,16788,16518,16681,107
2020, Indiana,Vermillion County,18165,2020,15439,14753,15271,168
2010, Indiana,Marion County,18097,2010,903393,566853,818927,84466
2020, Indiana,Marion County,18097,2020,977203,513036,847917,129286
2010, Indiana,Switzerland County,18155,2010,10613,10381,10466,147
2020, Indiana,Switzerland County,18155,2020,9737,9298,9623,114
2000, Indiana,Switzerland County,18155,2000,9065,8954,8987,78
2000, Indiana,Vanderburgh County,18163,2000,171922,153519,170243,1679
2010, Indiana,Newton County,18111,2010,14244,13700,13527,717
2010, Indiana,Vanderburgh County,18163,2010,179703,154882,175830,3873
2020, Indiana,Pike County,18125,2020,12250,11716,12070,180
2010, Indiana,Union County,18161,2010,7516,7331,7434,82
2020, Indiana,Carroll County,18015,2020,20306,18985,19483,823
2010, Indiana,Carroll County,18015,2010,20155,19500,19444,711
2000, Indiana,Hamilton County,18057,2000,182740,172475,179829,2911
2010, Indiana,Hamilton County,18057,2010,274569,242985,265143,9426
2020, Indiana,Hamilton County,18057,2020,347467,278968,329361,18106
2010, Indiana,Montgomery County,18107,2010,38124,36309,36385,1739
2000, Indiana,Montgomery County,18107,2000,37629,36414,37018,611
2010, Indiana,St. Joseph County,18141,2010,266931,209972,247536,19395
2000, Indiana,St. Joseph County,18141,2000,265559,218706,253002,12557
2020, Indiana,Boone County,18011,2020,70812,61825,68037,2775
2020, Indiana,Blackford County,18009,2020,12112,11380,11860,252
2010, Indiana,Blackford County,18009,2010,12766,12470,12649,117
2000, Indiana,Blackford County,18009,2000,14048,13823,13965,83
2010, Indiana,Boone County,18011,2010,56640,53953,55370,1270
2000, Indiana,Boone County,18011,2000,46107,45149,45573,534
2010, Indiana,Noble County,18113,2010,47536,43970,42969,4567
2000, Indiana,Union County,18161,2000,7349,7253,7327,22
2000, Indiana,Newton County,18111,2000,14566,14177,14144,422
2020, Indiana,Tipton County,18159,2020,15359,14509,14925,434
2020, Indiana,Vanderburgh County,18163,2020,180136,145199,173823,6313
2000, Indiana,Harrison County,18061,2000,34325,33769,33994,331
2010, Indiana,Wayne County,18177,2010,68917,62140,67113,1804
2000, Indiana,Wayne County,18177,2000,71097,65436,70126,971
2020, Indiana,Adams County,18001,2020,35809,33670,34172,1637
2000, Indiana,Adams County,18001,2000,33625,32720,32507,1118
2000, Indiana,Marion County,18097,2000,860454,606502,827164,33290
2020, Indiana,Wayne County,18177,2020,66553,57392,64058,2495
2020, Indiana,Hendricks County,18063,2020,174788,141092,166732,8056
2010, Indiana,Hendricks County,18063,2010,145448,131117,141069,4379
2000, Indiana,Hendricks County,18063,2000,104093,100664,102931,1162
2020, Indiana,Tippecanoe County,18157,2020,186251,135611,167604,18647
2010, Indiana,Tippecanoe County,18157,2010,172780,145190,159833,12947
2010, Indiana,Henry County,18065,2010,49462,47351,48771,691
2020, Indiana,Henry County,18065,2020,48914,45401,47937,977
2000, Indiana,Henry County,18065,2000,48508,47520,48121,387
2020, Indiana,Daviess County,18027,2020,33381,30340,31278,2103
2020, Indiana,Miami County,18103,2020,35962,31502,34776,1186
2000, Indiana,Miami County,18103,2000,36082,33804,35604,478
2010, Indiana,Warrick County,18173,2010,59689,56700,58743,946
2000, Indiana,Carroll County,18015,2000,20165,19691,19574,591
2010, Indiana,Ripley County,18137,2010,28818,28132,28373,445
2000, Indiana,Ripley County,18137,2000,26523,26071,26276,247
2020, Indiana,Harrison County,18061,2020,39654,36967,38726,928
2010, Indiana,Harrison County,18061,2010,39364,38341,38783,581
2000, Indiana,Vigo County,18167,2000,105848,95965,104573,1275
2020, Indiana,Vigo County,18167,2020,106153,89410,102914,3239
2010, Indiana,Vigo County,18167,2010,107848,95207,105379,2469
2020, Indiana,St. Joseph County,18141,2020,272912,194810,246336,26576
2020, Indiana,Dubois County,18037,2020,43637,38864,39491,4146
2000, Indiana,Dubois County,18037,2000,39674,38698,38571,1103
2010, Indiana,Dubois County,18037,2010,41889,39839,39368,2521
2010, Indiana,Benton County,18007,2010,8854,8489,8423,431
2020, Indiana,Benton County,18007,2020,8719,7954,8090,629
2000, Indiana,Benton County,18007,2000,9421,9129,9176,245
2010, Indiana,Greene County,18055,2010,33165,32548,32843,322
2020, Indiana,Greene County,18055,2020,30803,29226,30252,551
2000, Indiana,Greene County,18055,2000,33157,32691,32889,268
2000, Indiana,Warrick County,18173,2000,52383,51053,52043,340
2010, Indiana,Adams County,18001,2010,34387,33349,32975,1412
2020, Indiana,Ripley County,18137,2020,28995,27332,28454,541
2000, Indiana,Lake County,18089,2000,484564,323290,425436,59128
2010, Indiana,Porter County,18127,2010,164343,149995,150410,13933
2000, Indiana,Clinton County,18023,2000,33866,31962,31388,2478
2010, Indiana,Madison County,18095,2010,131636,115452,127447,4189
2000, Indiana,Madison County,18095,2000,133358,119892,131365,1993
2020, Indiana,Franklin County,18047,2020,22785,21830,22566,219
2000, Indiana,Jackson County,18071,2000,41335,39736,40223,1112
2000, Indiana,Crawford County,18025,2000,10743,10557,10643,100
2010, Indiana,Jackson County,18071,2010,42376,40044,39966,2410
2020, Indiana,Jackson County,18071,2020,46428,38701,40177,6251
2000, Indiana,Pulaski County,18131,2000,13755,13415,13564,191
2010, Indiana,Allen County,18003,2010,355329,281653,332236,23093
2020, Indiana,Morgan County,18109,2020,71780,67398,70506,1274
2000, Indiana,Morgan County,18109,2000,66689,65749,66199,490
2020, Indiana,Pulaski County,18131,2020,12514,11603,12056,458
2020, Indiana,Ohio County,18115,2020,5940,5654,5861,79
2010, Indiana,Martin County,18101,2010,10334,10164,10264,70
2000, Indiana,Martin County,18101,2000,10369,10258,10327,42
2010, Indiana,LaPorte County,18091,2010,111467,93787,105374,6093
2020, Indiana,Martin County,18101,2020,9812,9365,9720,92
2000, Indiana,Ohio County,18115,2000,5623,5550,5598,25
2000, Indiana,Gibson County,18051,2000,32500,31350,32271,229
2010, Indiana,Jennings County,18079,2010,28525,27611,27954,571
2010, Indiana,Parke County,18121,2010,17339,16671,17124,215
2010, Indiana,Jasper County,18073,2010,33478,32056,31655,1823
2000, Indiana,Allen County,18003,2000,331849,275697,317972,13877
2020, Indiana,Madison County,18095,2020,130129,108594,123866,6263
2020, Indiana,Allen County,18003,2020,385410,277055,352487,32923
2000, Indiana,Steuben County,18151,2000,33214,32281,32531,683
2020, Indiana,Steuben County,18151,2020,34435,31842,33008,1427
2010, Indiana,Steuben County,18151,2010,34185,33098,33203,982
2020, Indiana,Crawford County,18025,2020,10526,10030,10405,121
2010, Indiana,Crawford County,18025,2010,10713,10438,10587,126
2010, Indiana,Pulaski County,18131,2010,13402,13025,13077,325
2020, Indiana,LaPorte County,18091,2020,112417,88106,104432,7985
2020, Indiana,Gibson County,18051,2020,33011,30378,32331,680
2000, Indiana,Franklin County,18047,2000,22151,21934,22047,104
2010, Indiana,LaGrange County,18087,2010,37128,35874,35811,1317
2020, Indiana,Cass County,18017,2020,37870,30122,31195,6675
2020, Indiana,Jasper County,18073,2020,32918,29690,30576,2342
2020, Indiana,Starke County,18149,2020,23371,21768,22469,902
2000, Indiana,Starke County,18149,2000,23556,22971,23042,514
2000, Indiana,Fountain County,18045,2000,17954,17722,17764,190
2020, Indiana,Jennings County,18079,2020,27613,25880,26754,859
2000, Indiana,Jennings County,18079,2000,27554,26852,27361,193
2010, Indiana,Starke County,18149,2010,23363,22683,22597,766
2010, Indiana,Kosciusko County,18085,2010,77358,72188,71724,5634
2000, Indiana,Kosciusko County,18085,2000,74057,70041,70335,3722
2010, Indiana,Jay County,18075,2010,21253,20619,20676,577
2020, Indiana,Kosciusko County,18085,2020,80240,69590,72748,7492
2000, Indiana,Owen County,18119,2000,21786,21397,21622,164
2020, Indiana,Fulton County,18049,2020,20480,18848,19412,1068
2000, Indiana,Fulton County,18049,2000,20511,19734,20038,473
2010, Indiana,Fulton County,18049,2010,20836,19800,19954,882
2020, Indiana,Jay County,18075,2020,20478,19145,19534,944
2000, Indiana,LaGrange County,18087,2000,34909,33770,33812,1097
2000, Indiana,Cass County,18017,2000,40930,38352,38025,2905
2020, Indiana,Fountain County,18045,2020,16479,15463,16067,412
2010, Indiana,Fountain County,18045,2010,17240,16802,16867,373
2020, Indiana,Lake County,18089,2020,498700,275069,398773,99927
2010, Indiana,Cass County,18017,2010,38966,34385,34069,4897
2000, Indiana,LaPorte County,18091,2000,110106,94972,106704,3402
2000, Indiana,Putnam County,18133,2000,36019,34171,35607,412
2000, Indiana,Wells County,18179,2000,27600,27136,27203,397
2010, Indiana,Clinton County,18023,2010,33224,30232,28829,4395
2020, Indiana,Clinton County,18023,2020,33190,26867,27048,6142
2020, Indiana,LaGrange County,18087,2020,40446,38277,38713,1733
2010, Indiana,Wells County,18179,2010,27636,26902,27072,564
2000, Indiana,Jay County,18075,2000,21806,21291,21416,390
2020, Indiana,Wells County,18179,2020,28180,26322,27161,1019
2020, Indiana,Putnam County,18133,2020,36726,33332,35942,784
2020, Indiana,Parke County,18121,2020,16156,15406,15931,225
2010, Indiana,White County,18181,2010,24643,23132,22897,1746
2000, Indiana,Warren County,18171,2000,8419,8342,8382,37
2020, Indiana,Union County,18161,2020,7087,6789,7013,74
2020, Indiana,Knox County,18083,2020,36282,33366,35277,1005
2020, Indiana,White County,18181,2020,24688,21657,22235,2453
2000, Indiana,White County,18181,2000,25267,24054,23918,1349
2010, Indiana,Knox County,18083,2010,38440,36475,37850,590
2000, Indiana,Knox County,18083,2000,39256,37830,38934,322
2010, Indiana,Morgan County,18109,2010,68894,67307,68074,820
2000, Indiana,Orange County,18117,2000,19306,18900,19198,108
2020, Indiana,Spencer County,18147,2020,19810,18557,19134,676
2010, Indiana,Spencer County,18147,2010,20952,20295,20435,517
2000, Indiana,Clay County,18021,2000,26556,26127,26401,155
2010, Indiana,Clay County,18021,2010,26890,26303,26583,307
2000, Indiana,Washington County,18175,2000,27223,26884,27023,200
2020, Indiana,Clay County,18021,2020,26466,25043,26006,460
2010, Indiana,Washington County,18175,2010,28262,27714,27958,304
2000, Indiana,Spencer County,18147,2000,20391,19923,20088,303
2020, Indiana,Orange County,18117,2020,19867,18630,19562,305
2020, Indiana,Johnson County,18081,2020,161765,138621,155371,6394
2010, Indiana,Johnson County,18081,2010,139654,131140,135384,4270
2000, Indiana,Marshall County,18099,2000,45128,43109,42464,2664
2000, Indiana,Johnson County,18081,2000,115209,111796,113618,1591
2020, Indiana,Elkhart County,18039,2020,207047,151468,167453,39594
2000, Indiana,Elkhart County,18039,2000,182791,157931,166491,16300
2020, Indiana,Monroe County,18105,2020,139718,114435,133360,6358
2010, Indiana,Elkhart County,18039,2010,197559,163792,169673,27886
2000, Indiana,Monroe County,18105,2000,120563,109510,118328,2235
2010, Indiana,Monroe County,18105,2010,137974,121109,133945,4029
2010, Indiana,Orange County,18117,2010,19840,19245,19646,194
2020, Indiana,Washington County,18175,2020,28182,26791,27782,400
2000, Indiana,Jasper County,18073,2000,30043,29434,29310,733
2010, Indiana,Jefferson County,18077,2010,32428,30876,31673,755
2010, Indiana,Owen County,18119,2010,21575,21129,21377,198
2010, Indiana,Putnam County,18133,2010,37963,35449,37376,587
2010, Indiana,Ohio County,18115,2010,6128,6012,6059,69
2000, Indiana,Jefferson County,18077,2000,31705,30498,31373,332
2020, Indiana,Jefferson County,18077,2020,33147,30340,32036,1111
2020, Indiana,Owen County,18119,2020,21321,19962,21024,297
2000, Indiana,Parke County,18121,2000,17241,16625,17137,104
2000, Indiana,Huntington County,18069,2000,38075,37371,37712,363
2010, Indiana,Huntington County,18069,2010,37124,36062,36493,631
2010, Indiana,Franklin County,18047,2010,23087,22703,22877,210
2010, Indiana,Gibson County,18051,2010,33503,31986,33062,441
2010, Indiana,Marshall County,18099,2010,47051,44000,43080,3971
2020, Indiana,Marshall County,18099,2020,46095,40306,40844,5251
2020, Indiana,Huntington County,18069,2020,36662,34213,35612,1050
2010, Iowa,Guthrie County,19077,2010,10954,10687,10752,202
2010, Iowa,Cherokee County,19035,2010,12072,11667,11798,274
2020, Iowa,Franklin County,19069,2020,10019,8366,8385,1634
2020, Iowa,Cass County,19029,2020,13127,12413,12821,306
2020, Iowa,Dubuque County,19061,2020,99266,88314,96289,2977
2020, Iowa,Marion County,19125,2020,33414,31156,32714,700
2010, Iowa,Dubuque County,19061,2010,93653,88092,91846,1807
2020, Iowa,Cherokee County,19035,2020,11658,10831,11128,530
2010, Iowa,Marion County,19125,2010,33309,32203,32778,531
2020, Iowa,Carroll County,19027,2020,20760,19543,20166,594
2000, Iowa,Carroll County,19027,2000,21421,21178,21306,115
2000, Iowa,Linn County,19113,2000,191701,179999,188979,2722
2000, Iowa,Calhoun County,19025,2000,11115,10899,11015,100
2000, Iowa,Guthrie County,19077,2000,11353,11195,11233,120
2010, Iowa,Carroll County,19027,2010,20816,20250,20483,333
2020, Iowa,Boone County,19015,2020,26715,24943,26006,709
2000, Iowa,Franklin County,19069,2000,10704,10160,10062,642
2010, Iowa,Boone County,19015,2010,26306,25509,25801,505
2000, Iowa,Boone County,19015,2000,26224,25838,26006,218
2010, Iowa,Grundy County,19075,2010,12453,12269,12331,122
2020, Iowa,Grundy County,19075,2020,12329,11836,12184,145
2000, Iowa,Marion County,19125,2000,32052,31237,31795,257
2000, Iowa,Cherokee County,19035,2000,13035,12817,12911,124
2010, Iowa,Mahaska County,19123,2010,22381,21428,22021,360
2000, Iowa,Fremont County,19071,2000,8010,7851,7836,174
2000, Iowa,Mahaska County,19123,2000,22335,21710,22145,190
2000, Iowa,Marshall County,19127,2000,39311,35551,35788,3523
2010, Iowa,Fremont County,19071,2010,7441,7212,7254,187
2020, Iowa,Marshall County,19127,2020,40105,29579,30965,9140
2020, Iowa,Mahaska County,19123,2020,22190,20453,21710,480
2020, Iowa,Fremont County,19071,2020,6605,6201,6415,190
2000, Iowa,Grundy County,19075,2000,12369,12242,12297,72
2010, Iowa,Franklin County,19069,2010,10680,10001,9471,1209
2010, Iowa,Marshall County,19127,2010,40648,36071,33631,7017
2020, Iowa,Guthrie County,19077,2020,10623,10032,10349,274
2010, Iowa,Buchanan County,19019,2010,20958,20505,20715,243
2010, Iowa,Linn County,19113,2010,211226,191884,205692,5534
2010, Iowa,Lyon County,19119,2010,11581,11340,11369,212
2010, Iowa,Sac County,19161,2010,10350,10125,10155,195
2010, Iowa,Cerro Gordo County,19033,2010,44151,41964,42457,1694
2020, Iowa,Cerro Gordo County,19033,2020,43127,38618,40884,2243
2000, Iowa,Lyon County,19119,2000,11763,11661,11721,42
2010, Iowa,Louisa County,19115,2010,11387,10272,9590,1797
2000, Iowa,Webster County,19187,2000,40235,37574,39291,944
2020, Iowa,Lyon County,19119,2020,11934,11270,11527,407
2020, Iowa,Webster County,19187,2020,36999,32108,34936,2063
2010, Iowa,Fayette County,19065,2010,20880,20253,20500,380
2000, Iowa,Fayette County,19065,2000,22008,21505,21678,330
2000, Iowa,Louisa County,19115,2000,12183,11441,10646,1537
2010, Iowa,Webster County,19187,2010,38013,35095,36567,1446
2010, Iowa,Union County,19175,2010,12534,12144,12309,225
2000, Iowa,Emmet County,19063,2000,11027,10738,10552,475
2000, Iowa,Cerro Gordo County,19033,2000,46447,44711,45156,1291
2020, Iowa,Fayette County,19065,2020,19509,18271,18989,520
2000, Iowa,Union County,19175,2000,12309,12117,12184,125
2020, Iowa,Union County,19175,2020,12138,11365,11739,399
2010, Iowa,Floyd County,19067,2010,16303,15620,15972,331
2020, Iowa,Buchanan County,19019,2020,20565,19696,20227,338
2000, Iowa,Buchanan County,19019,2000,21093,20757,20962,131
2020, Iowa,Lucas County,19117,2020,8634,8207,8436,198
2000, Iowa,Lucas County,19117,2000,9422,9275,9340,82
2010, Iowa,Lucas County,19117,2010,8898,8769,8809,89
2000, Iowa,O'Brien County,19141,2000,15102,14807,14835,267
2020, Iowa,O'Brien County,19141,2020,14182,12825,13197,985
2010, Iowa,O'Brien County,19141,2010,14398,13829,13853,545
2020, Iowa,Cedar County,19031,2020,18505,17472,18043,462
2010, Iowa,Cedar County,19031,2010,18499,18090,18215,284
2000, Iowa,Cedar County,19031,2000,18187,17909,18016,171
2000, Iowa,Sac County,19161,2000,11529,11359,11418,111
2020, Iowa,Sac County,19161,2020,9814,9271,9460,354
2000, Iowa,Floyd County,19067,2000,16900,16581,16678,222
2000, Iowa,Buena Vista County,19021,2000,20411,17962,17851,2560
2010, Iowa,Buena Vista County,19021,2010,20260,16341,15652,4608
2020, Iowa,Floyd County,19067,2020,15627,14094,15077,550
2020, Iowa,Osceola County,19143,2020,6192,5485,5589,603
2000, Iowa,Dubuque County,19061,2000,89143,86531,88078,1065
2010, Iowa,Osceola County,19143,2010,6462,6149,6032,430
2010, Iowa,Emmet County,19063,2010,10302,9591,9539,763
2000, Iowa,Van Buren County,19177,2000,7809,7701,7749,60
2010, Iowa,Van Buren County,19177,2010,7570,7439,7482,88
2020, Iowa,Bremer County,19017,2020,24988,23597,24477,511
2010, Iowa,Bremer County,19017,2010,24276,23601,24037,239
2000, Iowa,Wayne County,19185,2000,6730,6648,6682,48
2010, Iowa,Wayne County,19185,2010,6403,6275,6334,69
2020, Iowa,Madison County,19121,2020,16548,15609,16232,316
2020, Iowa,Van Buren County,19177,2020,7203,6923,7089,114
2000, Iowa,Cass County,19029,2000,14684,14513,14583,101
2020, Iowa,Calhoun County,19025,2020,9927,9357,9691,236
2010, Iowa,Calhoun County,19025,2010,9670,9526,9580,90
2010, Iowa,Cass County,19029,2010,13956,13636,13703,253
2020, Iowa,Greene County,19073,2020,8771,8258,8515,256
2000, Iowa,Greene County,19073,2000,10366,10175,10194,172
2010, Iowa,Greene County,19073,2010,9336,9108,9165,171
2020, Iowa,Linn County,19113,2020,230299,190644,221388,8911
2000, Iowa,Bremer County,19017,2000,23325,22909,23195,130
2000, Iowa,Osceola County,19143,2000,7003,6866,6878,125
2010, Iowa,Madison County,19121,2010,15679,15376,15482,197
2020, Iowa,Wayne County,19185,2020,6497,6261,6436,61
2020, Iowa,Emmet County,19063,2020,9388,8356,8501,887
2010, Iowa,Scott County,19163,2010,165224,142267,156027,9197
2000, Iowa,Scott County,19163,2000,158668,140481,152223,6445
2000, Iowa,Shelby County,19165,2000,13173,12999,13085,88
2020, Iowa,Shelby County,19165,2020,11746,10990,11334,412
2020, Iowa,Scott County,19163,2020,174669,138752,162577,12092
2000, Iowa,Butler County,19023,2000,15305,15145,15216,89
2020, Iowa,Butler County,19023,2020,14334,13827,14151,183
2010, Iowa,Shelby County,19165,2010,12167,11909,11948,219
2010, Iowa,Butler County,19023,2010,14867,14636,14734,133
2010, Iowa,Palo Alto County,19147,2010,9421,9211,9269,152
2020, Iowa,Palo Alto County,19147,2020,8996,8465,8722,274
2000, Iowa,Palo Alto County,19147,2000,10147,10007,10070,77
2010, Iowa,Page County,19145,2010,15932,15039,15494,438
2020, Iowa,Page County,19145,2020,15211,13858,14747,464
2000, Iowa,Page County,19145,2000,16976,16315,16711,265
2000, Iowa,Madison County,19121,2000,14019,13818,13914,105
2020, Iowa,Louisa County,19115,2020,10837,8834,9109,1728
2020, Iowa,Buena Vista County,19021,2020,20823,12597,14898,5925
2020, Iowa,Montgomery County,19137,2020,10330,9698,9959,371
2000, Iowa,Winnebago County,19189,2000,11723,11415,11486,237
2020, Iowa,Mills County,19129,2020,14484,13504,14023,461
2000, Iowa,Mills County,19129,2000,14547,14251,14368,179
2010, Iowa,Muscatine County,19139,2010,42745,38061,35942,6803
2000, Iowa,Muscatine County,19139,2000,41722,37852,36749,4973
2000, Iowa,Clay County,19041,2000,17372,17039,17176,196
2010, Iowa,Clay County,19041,2010,16667,16077,16190,477
2020, Iowa,Clay County,19041,2020,16384,15230,15680,704
2000, Iowa,Humboldt County,19091,2000,10381,10239,10281,100
2020, Iowa,Humboldt County,19091,2020,9597,8920,9167,430
2010, Iowa,Humboldt County,19091,2010,9815,9418,9458,357
2000, Iowa,Poweshiek County,19157,2000,18815,18202,18589,226
2020, Iowa,Poweshiek County,19157,2020,18662,17209,18133,529
2010, Iowa,Poweshiek County,19157,2010,18914,17957,18458,456
2000, Iowa,Ida County,19093,2000,7837,7760,7800,37
2010, Iowa,Ida County,19093,2010,7089,6957,6989,100
2000, Iowa,Dallas County,19049,2000,40750,38609,38551,2199
2020, Iowa,Dallas County,19049,2020,99678,83359,93163,6515
2010, Iowa,Dallas County,19049,2010,66135,60971,62076,4059
2020, Iowa,Ida County,19093,2020,7005,6662,6750,255
2000, Iowa,Iowa County,19095,2000,15671,15467,15519,152
2020, Iowa,Iowa County,19095,2020,16662,15571,16167,495
2010, Iowa,Iowa County,19095,2010,16355,16002,16048,307
2000, Iowa,Appanoose County,19007,2000,13721,13469,13586,135
2010, Iowa,Appanoose County,19007,2010,12887,12586,12706,181
2000, Iowa,Clayton County,19043,2000,18678,18478,18536,142
2020, Iowa,Muscatine County,19139,2020,43235,34598,35466,7769
2010, Iowa,Winnebago County,19189,2010,10866,10441,10506,360
2010, Iowa,Audubon County,19009,2010,6119,6032,6082,37
2010, Iowa,Mills County,19129,2010,15059,14639,14700,359
2000, Iowa,Decatur County,19053,2000,8689,8381,8541,148
2020, Iowa,Decatur County,19053,2020,7645,7081,7434,211
2010, Iowa,Decatur County,19053,2010,8457,8068,8276,181
2010, Iowa,Wright County,19197,2010,13229,12545,11955,1274
2010, Iowa,Polk County,19153,2010,430640,364895,397993,32647
2020, Iowa,Polk County,19153,2020,492401,373903,444346,48055
2000, Iowa,Polk County,19153,2000,374601,330917,358111,16490
2000, Iowa,Ringgold County,19159,2000,5469,5418,5456,13
2010, Iowa,Ringgold County,19159,2010,5131,5004,5040,91
2020, Iowa,Ringgold County,19159,2020,4663,4469,4592,71
2010, Iowa,Howard County,19089,2010,9566,9380,9448,118
2000, Iowa,Howard County,19089,2000,9932,9839,9877,55
2020, Iowa,Appanoose County,19007,2020,12317,11690,12086,231
2020, Iowa,Howard County,19089,2020,9469,8940,9211,258
2020, Iowa,Clarke County,19039,2020,9748,8231,8214,1534
2000, Iowa,Clarke County,19039,2000,9133,8826,8764,369
2020, Iowa,Pottawattamie County,19155,2020,93667,81329,86007,7660
2000, Iowa,Pottawattamie County,19155,2000,87704,84181,84812,2892
2000, Iowa,Davis County,19051,2000,8541,8400,8480,61
2020, Iowa,Davis County,19051,2020,9110,8797,8966,144
2010, Iowa,Davis County,19051,2010,8753,8614,8668,85
2010, Iowa,Pottawattamie County,19155,2010,93158,86558,87007,6151
2020, Iowa,Story County,19169,2020,98537,81046,93505,5032
2000, Iowa,Story County,19169,2000,79981,72898,78743,1238
2010, Iowa,Story County,19169,2010,89542,79344,86847,2695
2020, Iowa,Audubon County,19009,2020,5674,5469,5588,86
2010, Iowa,Clarke County,19039,2010,9286,8758,8359,927
2000, Iowa,Wright County,19197,2000,14334,13750,13628,706
2020, Iowa,Clayton County,19043,2020,17043,16229,16700,343
2020, Iowa,Mitchell County,19131,2020,10565,10107,10372,193
2010, Iowa,Allamakee County,19005,2010,14330,13750,13573,757
2000, Iowa,Allamakee County,19005,2000,14675,14070,14155,520
2020, Iowa,Allamakee County,19005,2020,14061,12621,12840,1221
2000, Iowa,Crawford County,19047,2000,16942,15773,15460,1482
2010, Iowa,Crawford County,19047,2010,17096,14168,12965,4131
2020, Iowa,Crawford County,19047,2020,16525,11262,11613,4912
2020, Iowa,Warren County,19181,2020,52403,48539,50745,1658
2000, Iowa,Warren County,19181,2000,40671,39889,40230,441
2020, Iowa,Johnson County,19103,2020,152854,117090,142656,10198
2010, Iowa,Johnson County,19103,2010,130882,112083,124682,6200
2000, Iowa,Johnson County,19103,2000,111006,100051,108225,2781
2000, Iowa,Jones County,19105,2000,20221,19549,20008,213
2020, Iowa,Jones County,19105,2020,20646,19244,20149,497
2010, Iowa,Jones County,19105,2010,20638,19901,20368,270
2010, Iowa,Adams County,19003,2010,4029,3953,3992,37
2000, Iowa,Adams County,19003,2000,4482,4433,4456,26
2020, Iowa,Adams County,19003,2020,3704,3531,3662,42
2020, Iowa,Keokuk County,19107,2020,10033,9547,9818,215
2020, Iowa,Adair County,19001,2020,7496,7149,7310,186
2010, Iowa,Adair County,19001,2010,7682,7558,7581,101
2000, Iowa,Adair County,19001,2000,8243,8153,8185,58
2010, Iowa,Montgomery County,19137,2010,10740,10460,10435,305
2010, Iowa,Keokuk County,19107,2010,10511,10339,10421,90
2000, Iowa,Keokuk County,19107,2000,11400,11286,11339,61
2000, Iowa,Montgomery County,19137,2000,11771,11559,11618,153
2020, Iowa,Monroe County,19135,2020,7577,7225,7460,117
2000, Iowa,Monroe County,19135,2000,8016,7888,7976,40
2010, Iowa,Monroe County,19135,2010,7970,7764,7801,169
2010, Iowa,Warren County,19181,2010,46225,44887,45326,899
2010, Iowa,Mitchell County,19131,2010,10776,10621,10666,110
2010, Iowa,Clayton County,19043,2010,18129,17731,17823,306
2010, Iowa,Jackson County,19097,2010,19848,19339,19628,220
2000, Iowa,Jackson County,19097,2000,20296,20085,20175,121
2020, Iowa,Jackson County,19097,2020,19485,18461,19248,237
2020, Iowa,Kossuth County,19109,2020,14828,13916,14225,603
2010, Iowa,Kossuth County,19109,2010,15543,15223,15328,215
2000, Iowa,Clinton County,19045,2000,50149,48079,49522,627
2020, Iowa,Clinton County,19045,2020,46460,41771,44921,1539
2010, Iowa,Clinton County,19045,2010,49116,46152,47873,1243
2000, Iowa,Kossuth County,19109,2000,17163,16950,17024,139
2020, Iowa,Monona County,19133,2020,8751,8141,8515,236
2000, Iowa,Mitchell County,19131,2000,10874,10795,10811,63
2000, Iowa,Monona County,19133,2000,10020,9854,9950,70
2020, Iowa,Jasper County,19099,2020,37813,34866,36726,1087
2010, Iowa,Jasper County,19099,2010,36842,35639,36305,537
2000, Iowa,Jasper County,19099,2000,37213,36313,36838,375
2000, Iowa,Wapello County,19179,2000,36051,34709,35252,799
2020, Iowa,Wapello County,19179,2020,35437,28180,31105,4332
2010, Iowa,Wapello County,19179,2010,35625,32802,32391,3234
2000, Iowa,Jefferson County,19101,2000,16181,15537,15884,297
2010, Iowa,Jefferson County,19101,2010,16843,14759,16433,410
2020, Iowa,Jefferson County,19101,2020,15663,13565,15053,610
2010, Iowa,Washington County,19183,2010,21704,20796,20566,1138
2020, Iowa,Washington County,19183,2020,22565,20374,20953,1612
2000, Iowa,Washington County,19183,2000,20670,20059,20106,564
2010, Iowa,Monona County,19133,2010,9243,8972,9136,107
2020, Iowa,Wright County,19197,2020,12943,10542,10549,2394
2000, Iowa,Audubon County,19009,2000,6830,6773,6797,33
2010, Iowa,Dickinson County,19059,2010,16667,16386,16489,178
2020, Iowa,Taylor County,19173,2020,5896,5412,5497,399
2010, Iowa,Taylor County,19173,2010,6317,6068,5953,364
2000, Iowa,Taylor County,19173,2000,6958,6799,6693,265
2010, Iowa,Benton County,19011,2010,26076,25569,25801,275
2020, Iowa,Black Hawk County,19013,2020,131144,102832,124696,6448
2000, Iowa,Black Hawk County,19013,2000,128012,113194,125653,2359
2000, Iowa,Chickasaw County,19037,2000,13095,12931,13013,82
2000, Iowa,Tama County,19171,2000,18103,16362,17424,679
2020, Iowa,Chickasaw County,19037,2020,12012,11252,11531,481
2010, Iowa,Hancock County,19081,2010,11341,10957,10943,398
2010, Iowa,Worth County,19195,2010,7598,7435,7451,147
2020, Iowa,Worth County,19195,2020,7443,7041,7232,211
2020, Iowa,Pocahontas County,19151,2020,7078,6459,6724,354
2010, Iowa,Hardin County,19083,2010,17534,16799,16883,651
2000, Iowa,Benton County,19011,2000,25308,25015,25152,156
2000, Iowa,Plymouth County,19149,2000,24849,24393,24521,328
2020, Iowa,Plymouth County,19149,2020,25698,23289,24202,1496
2020, Iowa,Hardin County,19083,2020,16878,15465,16060,818
2020, Iowa,Benton County,19011,2020,25575,24258,25113,462
2000, Iowa,Hardin County,19083,2000,18812,18274,18357,455
2020, Iowa,Hancock County,19081,2020,10795,9959,10181,614
2000, Iowa,Hancock County,19081,2000,12100,11822,11799,301
2000, Iowa,Lee County,19111,2000,38052,35862,37150,902
2020, Iowa,Lee County,19111,2020,33555,30336,32445,1110
2010, Iowa,Des Moines County,19057,2010,40325,36704,39283,1042
2020, Iowa,Des Moines County,19057,2020,38910,33164,37665,1245
2000, Iowa,Des Moines County,19057,2000,42351,39679,41611,740
2010, Iowa,Lee County,19111,2010,35862,33537,34770,1092
2010, Iowa,Chickasaw County,19037,2010,12439,12119,12170,269
2020, Iowa,Tama County,19171,2020,17135,13658,15331,1804
2010, Iowa,Plymouth County,19149,2010,24986,24086,24244,742
2020, Iowa,Sioux County,19167,2020,35872,30745,30958,4914
2000, Iowa,Worth County,19195,2000,7909,7780,7785,124
2010, Iowa,Sioux County,19167,2010,33704,31441,30703,3001
2020, Iowa,Woodbury County,19193,2020,105941,76794,87195,18746
2000, Iowa,Pocahontas County,19151,2000,8662,8531,8585,77
2020, Iowa,Henry County,19087,2020,20482,17990,19399,1083
2010, Iowa,Delaware County,19055,2010,17764,17507,17625,139
2000, Iowa,Delaware County,19055,2000,18404,18271,18283,121
2010, Iowa,Black Hawk County,19013,2010,131090,112215,126183,4907
2020, Iowa,Delaware County,19055,2020,17488,16787,17244,244
2020, Iowa,Dickinson County,19059,2020,17703,16819,17297,406
2000, Iowa,Winneshiek County,19191,2000,21310,20852,21140,170
2000, Iowa,Dickinson County,19059,2000,16424,16244,16315,109
2020, Iowa,Winneshiek County,19191,2020,20070,18852,19485,585
2010, Iowa,Henry County,19087,2010,20145,18557,19381,764
2000, Iowa,Henry County,19087,2000,20336,19274,20080,256
2000, Iowa,Sioux County,19167,2000,31589,30746,30781,808
2010, Iowa,Pocahontas County,19151,2010,7310,7126,7144,166
2010, Iowa,Winneshiek County,19191,2010,21056,20347,20638,418
2020, Iowa,Winnebago County,19189,2020,10679,9665,10085,594
2000, Iowa,Hamilton County,19079,2000,16438,15898,16204,234
2010, Iowa,Woodbury County,19193,2010,102172,85387,88179,13993
2010, Iowa,Tama County,19171,2010,17767,15373,16447,1320
2000, Iowa,Harrison County,19085,2000,15666,15460,15553,113
2020, Iowa,Harrison County,19085,2020,14582,13922,14289,293
2010, Iowa,Harrison County,19085,2010,14928,14658,14745,183
2000, Iowa,Woodbury County,19193,2000,103877,90875,94409,9468
2020, Iowa,Hamilton County,19079,2020,15039,13079,13574,1465
2010, Iowa,Hamilton County,19079,2010,15673,14703,14891,782
2000, Kansas,Seward County,20175,2000,22510,14730,13024,9486
2020, Kansas,Lincoln County,20105,2020,2939,2740,2809,130
2010, Kansas,Anderson County,20003,2010,8102,7843,7979,123
2010, Kansas,Lincoln County,20105,2010,3241,3158,3169,72
2000, Kansas,Sherman County,20181,2000,6760,6343,6189,571
2010, Kansas,Seward County,20175,2010,22952,16171,9962,12990
2000, Kansas,Ottawa County,20143,2000,6163,6011,6083,80
2010, Kansas,Ottawa County,20143,2010,6091,5889,5970,121
2020, Kansas,Franklin County,20059,2020,25996,23187,24849,1147
2010, Kansas,Sherman County,20181,2010,6010,5596,5363,647
2010, Kansas,Franklin County,20059,2010,25992,24362,25055,937
2000, Kansas,Franklin County,20059,2000,24784,23556,24134,650
2010, Kansas,Phillips County,20147,2010,5642,5472,5521,121
2000, Kansas,Phillips County,20147,2000,6001,5896,5961,40
2010, Kansas,Jefferson County,20087,2010,19126,18419,18787,339
2020, Kansas,Phillips County,20147,2020,4981,4684,4839,142
2010, Kansas,Allen County,20001,2010,13371,12478,12979,392
2000, Kansas,Republic County,20157,2000,5835,5751,5780,55
2000, Kansas,Allen County,20001,2000,14385,13637,14107,278
2020, Kansas,Allen County,20001,2020,12526,11180,12024,502
2000, Kansas,Lincoln County,20105,2000,3578,3517,3541,37
2020, Kansas,Republic County,20157,2020,4674,4437,4583,91
2020, Kansas,Anderson County,20003,2020,7836,7312,7681,155
2020, Kansas,Seward County,20175,2020,21964,9015,7558,14406
2010, Kansas,Bourbon County,20011,2010,15173,14115,14864,309
2000, Kansas,Bourbon County,20011,2000,15379,14466,15180,199
2000, Kansas,Anderson County,20003,2000,8110,7900,8022,88
2000, Kansas,Jefferson County,20087,2000,18426,17818,18190,236
2020, Kansas,Jefferson County,20087,2020,18368,16797,17801,567
2020, Kansas,Ottawa County,20143,2020,5735,5338,5591,144
2020, Kansas,Bourbon County,20011,2020,14360,12585,13974,386
2010, Kansas,Republic County,20157,2010,4980,4879,4927,53
2020, Kansas,Grant County,20067,2020,7352,4223,3490,3862
2020, Kansas,Wilson County,20205,2020,8624,7759,8363,261
2010, Kansas,Johnson County,20091,2010,544179,468052,505230,38949
2000, Kansas,Johnson County,20091,2000,451086,410990,433129,17957
2020, Kansas,Johnson County,20091,2020,609863,473342,555474,54389
2020, Kansas,Kingman County,20095,2020,7470,6925,7202,268
2000, Kansas,Kingman County,20095,2000,8673,8452,8548,125
2010, Kansas,Kingman County,20095,2010,7858,7611,7659,199
2010, Kansas,Hamilton County,20075,2010,2690,2134,1863,827
2020, Kansas,Hamilton County,20075,2020,2518,1597,1434,1084
2010, Kansas,Kearny County,20093,2010,3977,3472,2842,1135
2020, Kansas,Kearny County,20093,2020,3983,2661,2587,1396
2000, Kansas,Kearny County,20093,2000,4531,3640,3328,1203
2020, Kansas,Rawlins County,20153,2020,2561,2283,2402,159
2000, Kansas,Hamilton County,20075,2000,2670,2180,2120,550
2000, Kansas,Marion County,20115,2000,13361,12968,13104,257
2010, Kansas,Marion County,20115,2010,12660,12154,12364,296
2020, Kansas,Marion County,20115,2020,11823,10910,11381,442
2000, Kansas,Rawlins County,20153,2000,2966,2922,2942,24
2000, Kansas,Finney County,20055,2000,40523,27982,22975,17548
2010, Kansas,Rawlins County,20153,2010,2519,2449,2439,80
2010, Kansas,Finney County,20055,2010,36776,28304,19594,17182
2020, Kansas,Finney County,20055,2020,38470,19812,18587,19883
2010, Kansas,Reno County,20155,2010,64511,58469,59302,5209
2000, Kansas,Wilson County,20205,2000,10332,9999,10159,173
2020, Kansas,Reno County,20155,2020,61898,52761,55802,6096
2020, Kansas,Stafford County,20185,2020,4072,3500,3569,503
2000, Kansas,Stanton County,20187,2000,2406,2031,1836,570
2020, Kansas,Stanton County,20187,2020,2084,1257,1175,909
2010, Kansas,Stanton County,20187,2010,2235,1870,1407,828
2000, Kansas,Kiowa County,20097,2000,3278,3186,3211,67
2010, Kansas,Wilson County,20205,2010,9409,8995,9192,217
2020, Kansas,Kiowa County,20097,2020,2460,2184,2373,87
2010, Kansas,Kiowa County,20097,2010,2553,2441,2454,99
2020, Kansas,Sherman County,20181,2020,5927,5025,5154,773
2010, Kansas,Osborne County,20141,2010,3858,3765,3812,46
2020, Kansas,Osborne County,20141,2020,3500,3304,3434,66
2000, Kansas,Osage County,20139,2000,16712,16256,16457,255
2020, Kansas,Osage County,20139,2020,15766,14706,15309,457
2000, Kansas,Ford County,20057,2000,32458,24295,20227,12231
2010, Kansas,Ford County,20057,2010,33848,25494,16527,17321
2020, Kansas,Ford County,20057,2020,34287,17167,14621,19666
2010, Kansas,Osage County,20139,2010,16295,15796,15965,330
2000, Kansas,Jewell County,20089,2000,3791,3745,3764,27
2020, Kansas,Jewell County,20089,2020,2932,2757,2870,62
2010, Kansas,Jewell County,20089,2010,3077,2994,3014,63
2010, Kansas,Stafford County,20185,2010,4437,4110,3908,529
2000, Kansas,Stafford County,20185,2000,4789,4548,4530,259
2000, Kansas,Reno County,20155,2000,64790,59320,61129,3661
2000, Kansas,Osborne County,20141,2000,4452,4390,4435,17
2000, Kansas,Rooks County,20163,2000,5685,5522,5625,60
2000, Kansas,Jackson County,20085,2000,12657,11418,12468,189
2010, Kansas,Brown County,20013,2010,9984,8494,9678,306
2020, Kansas,Wyandotte County,20209,2020,169245,73721,113431,55814
2010, Kansas,Wyandotte County,20209,2010,157505,86056,115872,41633
2020, Kansas,Pottawatomie County,20149,2020,25348,22618,23919,1429
2000, Kansas,Pottawatomie County,20149,2000,18209,17539,17798,411
2000, Kansas,Wichita County,20203,2000,2531,2183,2065,466
2020, Kansas,Wichita County,20203,2020,2152,1547,1516,636
2020, Kansas,Logan County,20109,2020,2762,2513,2567,195
2000, Kansas,Logan County,20109,2000,3046,2946,2996,50
2010, Kansas,Pottawatomie County,20149,2010,21604,20212,20647,957
2000, Kansas,Gray County,20069,2000,5904,5450,5325,579
2010, Kansas,Graham County,20065,2010,2597,2385,2538,59
2020, Kansas,Gove County,20063,2020,2718,2516,2635,83
2000, Kansas,Gove County,20063,2000,3068,3005,3030,38
2020, Kansas,Gray County,20069,2020,5653,4879,4814,839
2010, Kansas,Gray County,20069,2010,6006,5610,5151,855
2000, Kansas,Leavenworth County,20103,2000,68691,57824,66071,2620
2020, Kansas,Shawnee County,20177,2020,178909,132398,155048,23861
2020, Kansas,Leavenworth County,20103,2020,81881,64640,76279,5602
2010, Kansas,Leavenworth County,20103,2010,76227,63879,71919,4308
2020, Kansas,Woodson County,20207,2020,3115,2890,3044,71
2010, Kansas,Woodson County,20207,2010,3309,3161,3240,69
2000, Kansas,Greeley County,20071,2000,1534,1428,1357,177
2020, Kansas,Greeley County,20071,2020,1284,1075,1085,199
2010, Kansas,Gove County,20063,2010,2695,2646,2653,42
2000, Kansas,Graham County,20065,2000,2946,2796,2923,23
2020, Kansas,Smith County,20183,2020,3570,3390,3503,67
2020, Kansas,Graham County,20065,2020,2415,2212,2353,62
2000, Kansas,Grant County,20067,2000,7909,6090,5167,2742
2020, Kansas,Sumner County,20191,2020,22382,19934,21128,1254
2010, Kansas,Sumner County,20191,2010,24132,22705,23035,1097
2000, Kansas,Sumner County,20191,2000,25946,24551,25017,929
2000, Kansas,Barton County,20009,2000,28205,26225,25861,2344
2010, Kansas,Barton County,20009,2010,27674,24567,23991,3683
2020, Kansas,Barton County,20009,2020,25493,21157,21366,4127
2010, Kansas,Logan County,20109,2010,2756,2647,2676,80
2010, Kansas,Riley County,20161,2010,71115,59203,66505,4610
2020, Kansas,Riley County,20161,2020,71959,54567,64489,7470
2000, Kansas,Barber County,20007,2000,5307,5151,5200,107
2010, Kansas,Hodgeman County,20083,2010,1916,1806,1798,118
2000, Kansas,Hodgeman County,20083,2000,2085,2029,2029,56
2020, Kansas,Hodgeman County,20083,2020,1723,1584,1627,96
2010, Kansas,Barber County,20007,2010,4861,4673,4742,119
2020, Kansas,Barber County,20007,2020,4228,3857,4066,162
2000, Kansas,Riley County,20161,2000,62843,53281,59971,2872
2000, Kansas,Wyandotte County,20209,2000,157882,91856,132625,25257
2010, Kansas,Lane County,20101,2010,1750,1666,1676,74
2000, Kansas,Lane County,20101,2000,2155,2106,2124,31
2020, Kansas,Lane County,20101,2020,1574,1406,1431,143
2000, Kansas,Smith County,20183,2000,4536,4481,4503,33
2010, Kansas,Smith County,20183,2010,3853,3733,3796,57
2000, Kansas,Brown County,20013,2000,10724,9316,10475,249
2020, Kansas,Brown County,20013,2020,9508,7772,9156,352
2010, Kansas,Greeley County,20071,2010,1247,1143,1076,171
2020, Kansas,Thomas County,20193,2020,7930,7100,7298,632
2000, Kansas,Thomas County,20193,2000,8180,7946,8029,151
2010, Kansas,Shawnee County,20177,2010,177934,144412,158631,19303
2000, Kansas,Stevens County,20189,2000,5463,4535,4276,1187
2020, Kansas,Labette County,20099,2020,20184,16464,19245,939
2000, Kansas,Rice County,20159,2000,10761,10188,10157,604
2010, Kansas,Rice County,20159,2010,10083,9213,9065,1018
2020, Kansas,Rice County,20159,2020,9427,7853,8137,1290
2010, Kansas,Labette County,20099,2010,21607,19024,20732,875
2000, Kansas,Butler County,20015,2000,59482,56471,58146,1336
2010, Kansas,Butler County,20015,2010,65880,61576,63278,2602
2020, Kansas,Butler County,20015,2020,67380,58119,63802,3578
2010, Kansas,Geary County,20061,2010,34362,22738,30110,4252
2000, Kansas,Geary County,20061,2000,27947,17923,25585,2362
2020, Kansas,Geary County,20061,2020,36739,21857,30963,5776
2020, Kansas,Rooks County,20163,2020,4919,4619,4803,116
2010, Kansas,Rooks County,20163,2010,5181,5049,5074,107
2010, Kansas,Grant County,20067,2010,7829,6368,4390,3439
2020, Kansas,Greenwood County,20073,2020,6016,5494,5812,204
2000, Kansas,Greenwood County,20073,2000,7673,7407,7541,132
2010, Kansas,Greenwood County,20073,2010,6689,6394,6469,220
2010, Kansas,Trego County,20195,2010,3001,2919,2950,51
2020, Kansas,Trego County,20195,2020,2808,2644,2744,64
2020, Kansas,Sheridan County,20179,2020,2447,2257,2302,145
2000, Kansas,Trego County,20195,2000,3319,3245,3293,26
2000, Kansas,Harper County,20077,2000,6536,6355,6466,70
2010, Kansas,Jackson County,20085,2010,13462,11743,13024,438
2020, Kansas,Jackson County,20085,2020,13232,10727,12602,630
2010, Kansas,Stevens County,20189,2010,5724,4985,3858,1866
2010, Kansas,Harper County,20077,2010,6034,5711,5736,298
2020, Kansas,Stevens County,20189,2020,5250,3484,3230,2020
2010, Kansas,Harvey County,20079,2010,34684,31693,30937,3747
2010, Kansas,Thomas County,20193,2010,7900,7509,7530,370
2000, Kansas,Shawnee County,20177,2000,169871,140811,157541,12330
2000, Kansas,Woodson County,20207,2000,3788,3673,3736,52
2010, Kansas,Haskell County,20081,2010,4256,3641,3107,1149
2020, Kansas,Haskell County,20081,2020,3780,2842,2661,1119
2000, Kansas,Haskell County,20081,2000,4307,3664,3292,1015
2010, Kansas,Pratt County,20151,2010,9656,9083,9131,525
2020, Kansas,Pratt County,20151,2020,9157,8104,8416,741
2010, Kansas,Atchison County,20005,2010,16924,15395,16541,383
2020, Kansas,Atchison County,20005,2020,16348,14111,15765,583
2010, Kansas,Lyon County,20111,2010,33690,28140,26935,6755
2000, Kansas,Lyon County,20111,2000,35935,29924,29925,6010
2020, Kansas,Lyon County,20111,2020,32179,23801,24923,7256
2000, Kansas,Atchison County,20005,2000,16774,15369,16447,327
2000, Kansas,Pratt County,20151,2000,9647,9192,9349,298
2010, Kansas,Sheridan County,20179,2010,2556,2475,2472,84
2000, Kansas,Sheridan County,20179,2000,2813,2775,2772,41
2000, Kansas,Linn County,20107,2000,9570,9331,9483,87
2020, Kansas,Linn County,20107,2020,9591,8906,9353,238
2000, Kansas,Pawnee County,20145,2000,7233,6579,6932,301
2020, Kansas,Pawnee County,20145,2020,6253,5361,5731,522
2010, Kansas,Linn County,20107,2010,9656,9307,9470,186
2010, Kansas,Pawnee County,20145,2010,6973,6322,6512,461
2000, Kansas,Harvey County,20079,2000,32869,29924,30249,2620
2020, Kansas,Harvey County,20079,2020,34024,28658,29969,4055
2000, Kansas,Labette County,20099,2000,22835,20386,22135,700
2020, Kansas,Harper County,20077,2020,5485,4829,5060,425
2010, Kansas,Wichita County,20203,2010,2234,1972,1684,550
2020, Kansas,Ellsworth County,20053,2020,6376,5655,6011,365
2010, Kansas,Cowley County,20035,2010,36311,31317,33019,3292
2000, Kansas,Meade County,20119,2000,4631,4219,4126,505
2020, Kansas,Saline County,20169,2020,54303,43415,47661,6642
2000, Kansas,Russell County,20167,2000,7370,7192,7303,67
2000, Kansas,Mitchell County,20123,2000,6932,6766,6871,61
2020, Kansas,Mitchell County,20123,2020,5796,5490,5639,157
2000, Kansas,Morton County,20129,2000,3496,3090,3003,493
2010, Kansas,Clark County,20025,2010,2215,2047,2052,163
2000, Kansas,Clark County,20025,2000,2390,2289,2294,96
2020, Kansas,Clark County,20025,2020,1991,1724,1788,203
2020, Kansas,Cheyenne County,20023,2020,2616,2282,2378,238
2020, Kansas,Morton County,20129,2020,2701,2076,2110,591
2010, Kansas,Cheyenne County,20023,2010,2726,2664,2584,142
2000, Kansas,Cheyenne County,20023,2000,3165,3099,3083,82
2010, Kansas,Morton County,20129,2010,3233,2841,2610,623
2010, Kansas,Crawford County,20037,2010,39134,35685,37372,1762
2020, Kansas,Norton County,20137,2020,5459,4863,5148,311
2000, Kansas,Edwards County,20047,2000,3449,3191,3114,335
2020, Kansas,Edwards County,20047,2020,2907,2400,2284,623
2010, Kansas,Edwards County,20047,2010,3037,2758,2503,534
2000, Kansas,Wabaunsee County,20197,2000,6885,6695,6757,128
2010, Kansas,Wabaunsee County,20197,2010,7053,6808,6848,205
2010, Kansas,Norton County,20137,2010,5671,5358,5431,240
2020, Kansas,Cowley County,20035,2020,34549,27413,30578,3971
2000, Kansas,Norton County,20137,2000,5953,5557,5812,141
2020, Kansas,Nemaha County,20131,2020,10273,9700,10007,266
2010, Kansas,Russell County,20167,2010,6970,6712,6855,115
2000, Kansas,Scott County,20171,2000,5120,4888,4797,323
2010, Kansas,Scott County,20171,2010,4936,4447,4183,753
2020, Kansas,Russell County,20167,2020,6691,6138,6455,236
2010, Kansas,Chase County,20017,2010,2790,2661,2690,100
2000, Kansas,Nemaha County,20131,2000,10717,10540,10641,76
2010, Kansas,Doniphan County,20043,2010,7945,7396,7780,165
2020, Kansas,Doniphan County,20043,2020,7510,6701,7306,204
2000, Kansas,Doniphan County,20043,2000,8249,7824,8153,96
2000, Kansas,Clay County,20027,2000,8822,8621,8749,73
2010, Kansas,Clay County,20027,2010,8535,8301,8373,162
2000, Kansas,Marshall County,20117,2000,10965,10761,10882,83
2010, Kansas,Marshall County,20117,2010,10117,9849,9924,193
2020, Kansas,Clay County,20027,2020,8117,7542,7899,218
2020, Kansas,Wallace County,20199,2020,1512,1370,1432,80
2010, Kansas,Ellsworth County,20053,2010,6497,5991,6175,322
2000, Kansas,Wallace County,20199,2000,1749,1655,1665,84
2000, Kansas,Comanche County,20033,2000,1967,1927,1932,35
2010, Kansas,Wallace County,20199,2010,1485,1395,1377,108
2010, Kansas,Chautauqua County,20019,2010,3669,3331,3582,87
2000, Kansas,Chautauqua County,20019,2000,4359,4090,4300,59
2020, Kansas,Chautauqua County,20019,2020,3379,2847,3241,138
2020, Kansas,Comanche County,20033,2020,1689,1560,1591,98
2000, Kansas,Cowley County,20035,2000,36291,32708,34987,1304
2000, Kansas,Rush County,20165,2000,3551,3496,3514,37
2020, Kansas,Chase County,20017,2020,2572,2271,2350,222
2020, Kansas,Douglas County,20045,2020,118785,92694,110490,8295
2010, Kansas,Mitchell County,20123,2010,6373,6244,6300,73
2010, Kansas,Meade County,20119,2010,4575,4242,3899,676
2020, Kansas,Meade County,20119,2020,4055,3262,3258,797
2020, Kansas,McPherson County,20113,2020,30223,26965,28631,1592
2000, Kansas,McPherson County,20113,2000,29554,28527,28981,573
2010, Kansas,McPherson County,20113,2010,29180,27763,28155,1025
2000, Kansas,Chase County,20017,2000,3030,2936,2977,53
2000, Kansas,Crawford County,20037,2000,38242,35676,37332,910
2020, Kansas,Cherokee County,20021,2020,19362,16475,18848,514
2020, Kansas,Marshall County,20117,2020,10038,9480,9811,227
2010, Kansas,Cherokee County,20021,2010,21603,19513,21179,424
2000, Kansas,Cherokee County,20021,2000,22605,20857,22314,291
2010, Kansas,Douglas County,20045,2010,110826,93667,105175,5651
2000, Kansas,Douglas County,20045,2000,99962,86060,96694,3268
2020, Kansas,Crawford County,20037,2020,38972,32587,36256,2716
2020, Kansas,Rush County,20165,2020,2956,2800,2824,132
2020, Kansas,Scott County,20171,2020,5151,4173,4124,1027
2010, Kansas,Comanche County,20033,2010,1891,1825,1818,73
2000, Kansas,Decatur County,20039,2000,3472,3398,3438,34
2010, Kansas,Rush County,20165,2010,3307,3213,3223,84
2010, Kansas,Montgomery County,20125,2010,35471,29561,33627,1844
2020, Kansas,Montgomery County,20125,2020,31486,24297,29072,2414
2000, Kansas,Ellis County,20051,2000,27507,26433,26855,652
2010, Kansas,Neosho County,20133,2010,16512,15542,15826,686
2020, Kansas,Neosho County,20133,2020,15904,14105,14994,910
2010, Kansas,Saline County,20169,2010,55606,48695,50203,5403
2010, Kansas,Coffey County,20031,2010,8601,8298,8425,176
2000, Kansas,Cloud County,20029,2000,10268,10093,10206,62
2010, Kansas,Cloud County,20029,2010,9533,9189,9250,283
2020, Kansas,Cloud County,20029,2020,9032,8338,8713,319
2010, Kansas,Decatur County,20039,2010,2961,2883,2931,30
2020, Kansas,Coffey County,20031,2020,8360,7777,8139,221
2000, Kansas,Miami County,20121,2000,28351,27206,27900,451
2010, Kansas,Miami County,20121,2010,32787,31225,31959,828
2010, Kansas,Ness County,20135,2010,3107,2969,2878,229
2020, Kansas,Ellis County,20051,2020,28934,25584,26918,2016
2000, Kansas,Neosho County,20133,2000,16997,16130,16503,494
2010, Kansas,Ellis County,20051,2010,28452,26682,27153,1299
2020, Kansas,Ness County,20135,2020,2687,2347,2382,305
2020, Kansas,Miami County,20121,2020,34191,30907,32995,1196
2000, Kansas,Ness County,20135,2000,3454,3393,3402,52
2000, Kansas,Sedgwick County,20173,2000,452869,359489,416472,36397
2020, Kansas,Sedgwick County,20173,2020,523824,357757,441194,82630
2010, Kansas,Sedgwick County,20173,2010,498365,380482,433729,64636
2000, Kansas,Coffey County,20031,2000,8865,8595,8728,137
2010, Kansas,Elk County,20049,2010,2882,2742,2803,79
2000, Kansas,Saline County,20169,2000,53597,47794,50369,3228
2000, Kansas,Montgomery County,20125,2000,36252,31095,35134,1118
2010, Kansas,Dickinson County,20041,2010,19754,18780,18985,769
2010, Kansas,Nemaha County,20131,2010,10178,9902,10057,121
2020, Kansas,Decatur County,20039,2020,2764,2605,2688,76
2020, Kansas,Morris County,20127,2020,5386,4985,5159,227
2000, Kansas,Dickinson County,20041,2000,19344,18655,18899,445
2010, Kansas,Washington County,20201,2010,5799,5632,5655,144
2010, Kansas,Morris County,20127,2010,5923,5687,5711,212
2000, Kansas,Washington County,20201,2000,6483,6412,6441,42
2000, Kansas,Morris County,20127,2000,6104,5951,5968,136
2000, Kansas,Elk County,20049,2000,3261,3100,3190,71
2020, Kansas,Washington County,20201,2020,5530,5153,5255,275
2020, Kansas,Wabaunsee County,20197,2020,6877,6303,6560,317
2020, Kansas,Elk County,20049,2020,2483,2253,2382,101
2000, Kansas,Ellsworth County,20053,2000,6525,6112,6291,234
2020, Kansas,Dickinson County,20041,2020,18402,16814,17497,905
2000, Kentucky,Breathitt County,21025,2000,16100,15889,15994,106
2020, Kentucky,McCreary County,21147,2020,16888,15315,16523,365
2000, Kentucky,Bullitt County,21029,2000,61236,60052,60853,383
2010, Kentucky,Grayson County,21085,2010,25746,25052,25488,258
2020, Kentucky,Breckinridge County,21027,2020,20432,18831,20148,284
2020, Kentucky,Morgan County,21175,2020,13726,12570,13309,417
2010, Kentucky,Bullitt County,21029,2010,74319,71969,73281,1038
2020, Kentucky,Bullitt County,21029,2020,82217,75417,80100,2117
2020, Kentucky,Pendleton County,21191,2020,14644,13904,14443,201
2000, Kentucky,Grayson County,21085,2000,24053,23634,23867,186
2020, Kentucky,Breathitt County,21025,2020,13718,13083,13625,93
2010, Kentucky,Graves County,21083,2010,37121,33568,35022,2099
2010, Kentucky,McCreary County,21147,2010,18306,16724,17914,392
2010, Kentucky,Breathitt County,21025,2010,13878,13637,13789,89
2020, Kentucky,Grayson County,21085,2020,26420,24904,26056,364
2000, Kentucky,Green County,21087,2000,11518,11079,11409,109
2010, Kentucky,Mason County,21161,2010,17490,15801,17242,248
2010, Kentucky,Breckinridge County,21027,2010,20059,19206,19884,175
2000, Kentucky,McCreary County,21147,2000,17080,16737,16974,106
2010, Kentucky,McCracken County,21145,2010,65565,55762,64182,1383
2000, Kentucky,Mason County,21161,2000,16800,15268,16640,160
2000, Kentucky,Morgan County,21175,2000,13948,13193,13863,85
2020, Kentucky,McCracken County,21145,2020,67875,54304,65740,2135
2020, Kentucky,Livingston County,21139,2020,8888,8287,8702,186
2010, Kentucky,Livingston County,21139,2010,9519,9318,9396,123
2000, Kentucky,Livingston County,21139,2000,9804,9656,9730,74
2020, Kentucky,Mason County,21161,2020,17120,14867,16764,356
2020, Kentucky,Muhlenberg County,21177,2020,30928,28366,30359,569
2010, Kentucky,Muhlenberg County,21177,2010,31499,29514,31132,367
2010, Kentucky,Green County,21087,2010,11258,10775,11099,159
2000, Kentucky,Breckinridge County,21027,2000,18648,17872,18514,134
2020, Kentucky,Green County,21087,2020,11107,10447,10908,199
2000, Kentucky,Muhlenberg County,21177,2000,31839,29989,31607,232
2000, Kentucky,McCracken County,21145,2000,65514,56841,64820,694
2010, Kentucky,Morgan County,21175,2010,13923,13124,13815,108
2020, Kentucky,Graves County,21083,2020,36649,31149,33876,2773
2010, Kentucky,Todd County,21219,2010,12460,11093,11966,494
2010, Kentucky,Allen County,21003,2010,19956,19362,19659,297
2000, Kentucky,Cumberland County,21057,2000,7147,6810,7104,43
2010, Kentucky,Shelby County,21211,2010,42074,35943,38262,3812
2020, Kentucky,Shelby County,21211,2020,48065,38653,42770,5295
2000, Kentucky,Jackson County,21109,2000,13495,13383,13423,72
2020, Kentucky,Jackson County,21109,2020,12955,12559,12859,96
2010, Kentucky,Jackson County,21109,2010,13494,13348,13410,84
2020, Kentucky,Cumberland County,21057,2020,5888,5462,5811,77
2010, Kentucky,Edmonson County,21061,2010,12161,11789,12061,100
2000, Kentucky,Edmonson County,21061,2000,11644,11457,11579,65
2020, Kentucky,Edmonson County,21061,2020,12126,11546,11970,156
2010, Kentucky,Scott County,21209,2010,47173,42405,45179,1994
2000, Kentucky,Scott County,21209,2000,33061,30397,32530,531
2020, Kentucky,Scott County,21209,2020,57155,48523,54052,3103
2000, Kentucky,Clinton County,21053,2000,9634,9546,9516,118
2020, Kentucky,Clinton County,21053,2020,9253,8745,9008,245
2010, Kentucky,Clinton County,21053,2010,10272,9938,10041,231
2020, Kentucky,Todd County,21219,2020,12243,10354,11645,598
2000, Kentucky,Todd County,21219,2000,11971,10692,11772,199
2020, Kentucky,Whitley County,21235,2020,36712,34307,36025,687
2010, Kentucky,Whitley County,21235,2010,35637,34704,35327,310
2000, Kentucky,Whitley County,21235,2000,35865,35280,35616,249
2020, Kentucky,Anderson County,21005,2020,23852,21797,23331,521
2000, Kentucky,Anderson County,21005,2000,19111,18448,18958,153
2000, Kentucky,Wayne County,21231,2000,19923,19321,19632,291
2000, Kentucky,Pendleton County,21191,2000,14390,14159,14293,97
2010, Kentucky,Rockcastle County,21203,2010,17056,16783,16953,103
2000, Kentucky,Rockcastle County,21203,2000,16582,16385,16480,102
2000, Kentucky,Allen County,21003,2000,17800,17376,17653,147
2000, Kentucky,Graves County,21083,2000,37028,34335,36140,888
2010, Kentucky,Perry County,21193,2010,28712,27706,28527,185
2020, Kentucky,Allen County,21003,2020,20588,19135,20014,574
2000, Kentucky,Pulaski County,21199,2000,56217,54798,55763,454
2010, Kentucky,Logan County,21141,2010,26835,24187,26184,651
2000, Kentucky,Logan County,21141,2000,26573,24101,26285,288
2020, Kentucky,Elliott County,21063,2020,7354,6903,7263,91
2010, Kentucky,Anderson County,21005,2010,21421,20458,21133,288
2020, Kentucky,Logan County,21141,2020,27432,23902,26579,853
2010, Kentucky,Elliott County,21063,2010,7852,7506,7790,62
2010, Kentucky,Pulaski County,21199,2010,63063,60625,61745,1318
2020, Kentucky,Pulaski County,21199,2020,65034,60111,63157,1877
2000, Kentucky,Elliott County,21063,2000,6748,6683,6708,40
2000, Kentucky,Shelby County,21211,2000,33337,28874,31832,1505
2020, Kentucky,Perry County,21193,2020,28473,26820,28252,221
2000, Kentucky,Perry County,21193,2000,29390,28609,29236,154
2010, Kentucky,Wayne County,21231,2010,20813,19805,20212,601
2010, Kentucky,Grant County,21081,2010,24662,23842,24085,577
2010, Kentucky,Christian County,21047,2010,73955,52896,69414,4541
2020, Kentucky,Grant County,21081,2020,24941,23002,24200,741
2020, Kentucky,Wayne County,21231,2020,19555,18139,18653,902
2010, Kentucky,Cumberland County,21057,2010,6856,6540,6793,63
2020, Kentucky,Rockcastle County,21203,2020,16037,15378,15865,172
2010, Kentucky,Pendleton County,21191,2010,14877,14603,14734,143
2010, Kentucky,Kenton County,21117,2010,159720,145394,155495,4225
2000, Kentucky,Bracken County,21023,2000,8279,8153,8240,39
2010, Kentucky,Menifee County,21165,2010,6306,6088,6255,51
2000, Kentucky,Menifee County,21165,2000,6556,6401,6483,73
2000, Kentucky,Bath County,21011,2000,11085,10738,10996,89
2010, Kentucky,Hickman County,21105,2010,4902,4332,4845,57
2020, Kentucky,Hickman County,21105,2020,4521,3902,4419,102
2000, Kentucky,Hickman County,21105,2000,5262,4649,5208,54
2020, Kentucky,Bath County,21011,2020,12750,12192,12568,182
2010, Kentucky,Bath County,21011,2010,11591,11175,11434,157
2010, Kentucky,Simpson County,21213,2010,17327,15118,17002,325
2020, Kentucky,Harlan County,21095,2020,26831,25107,26566,265
2000, Kentucky,Harlan County,21095,2000,33202,31728,32986,216
2010, Kentucky,Harlan County,21095,2010,29278,28144,29068,210
2020, Kentucky,Laurel County,21125,2020,62613,58888,61602,1011
2000, Kentucky,Laurel County,21125,2000,52715,51484,52424,291
2020, Kentucky,Menifee County,21165,2020,6113,5891,6056,57
2010, Kentucky,Laurel County,21125,2010,58849,57112,58132,717
2010, Kentucky,Leslie County,21131,2010,11310,11179,11270,40
2020, Kentucky,Leslie County,21131,2020,10513,10197,10441,72
2010, Kentucky,Barren County,21009,2010,42173,38997,41063,1110
2000, Kentucky,Barren County,21009,2000,38033,35864,37678,355
2020, Kentucky,Barren County,21009,2020,44485,39270,42596,1889
2000, Kentucky,Leslie County,21131,2000,12401,12296,12324,77
2010, Kentucky,Letcher County,21133,2010,24519,24215,24395,124
2020, Kentucky,Letcher County,21133,2020,21548,20841,21415,133
2020, Kentucky,Hardin County,21093,2020,110702,82959,104007,6695
2010, Kentucky,Hardin County,21093,2010,105543,84971,100226,5317
2000, Kentucky,Hardin County,21093,2000,94174,77217,91015,3159
2000, Kentucky,Letcher County,21133,2000,25277,24952,25167,110
2010, Kentucky,Wolfe County,21237,2010,7355,7265,7314,41
2010, Kentucky,Nelson County,21179,2010,43437,39932,42549,888
2000, Kentucky,Simpson County,21213,2000,16405,14410,16255,150
2010, Kentucky,Larue County,21123,2010,14193,13329,13792,401
2020, Kentucky,Lawrence County,21127,2020,16293,15787,16145,148
2010, Kentucky,Harrison County,21097,2010,18846,18037,18509,337
2020, Kentucky,Christian County,21047,2020,72748,48279,66996,5752
2020, Kentucky,Henderson County,21101,2020,44793,37648,43425,1368
2010, Kentucky,Bell County,21013,2010,28691,27415,28493,198
2000, Kentucky,Bell County,21013,2000,30060,28864,29866,194
2020, Kentucky,Bell County,21013,2020,24097,22388,23853,244
2010, Kentucky,Henderson County,21101,2010,46250,41217,45392,858
2000, Kentucky,Henderson County,21101,2000,44829,40866,44396,433
2010, Kentucky,Woodford County,21239,2010,24939,22363,23259,1680
2020, Kentucky,Woodford County,21239,2020,26871,22701,24858,2013
2000, Kentucky,Woodford County,21239,2000,23208,21371,22513,695
2000, Kentucky,Christian County,21047,2000,72265,50529,68771,3494
2020, Kentucky,Mercer County,21167,2020,22641,20268,21938,703
2010, Kentucky,Lee County,21129,2010,7887,7607,7829,58
2010, Kentucky,Mercer County,21167,2010,21331,19789,20841,490
2000, Kentucky,Harrison County,21097,2000,17983,17200,17776,207
2000, Kentucky,Mercer County,21167,2000,20817,19568,20552,265
2000, Kentucky,Hart County,21099,2000,17445,16150,17295,150
2020, Kentucky,Hart County,21099,2020,19288,17577,18954,334
2000, Kentucky,Metcalfe County,21169,2000,10037,9762,9984,53
2020, Kentucky,Metcalfe County,21169,2020,10286,9701,10056,230
2010, Kentucky,Metcalfe County,21169,2010,10099,9774,9984,115
2000, Kentucky,Lee County,21129,2000,7916,7528,7887,29
2020, Kentucky,Lee County,21129,2020,7395,6909,7335,60
2010, Kentucky,Henry County,21103,2010,15416,14452,14969,447
2020, Kentucky,Henry County,21103,2020,15678,14215,15133,545
2000, Kentucky,Henry County,21103,2000,15060,14152,14721,339
2020, Kentucky,Simpson County,21213,2020,19594,16374,18946,648
2010, Kentucky,Lawrence County,21127,2010,15860,15621,15783,77
2000, Kentucky,Lawrence County,21127,2000,15569,15403,15505,64
2020, Kentucky,Harrison County,21097,2020,18692,17357,18305,387
2010, Kentucky,Hart County,21099,2010,18199,16906,17938,261
2020, Kentucky,Bracken County,21023,2020,8400,7994,8310,90
2020, Kentucky,Larue County,21123,2020,14867,13490,14388,479
2000, Kentucky,Pike County,21195,2000,68736,67599,68286,450
2000, Kentucky,Boone County,21015,2000,85991,81822,84289,1702
2010, Kentucky,Boone County,21015,2010,118811,109050,114606,4205
2010, Kentucky,Robertson County,21201,2010,2282,2241,2260,22
2000, Kentucky,Daviess County,21059,2000,91545,85772,90700,845
2020, Kentucky,Bourbon County,21017,2020,20252,17076,18766,1486
2010, Kentucky,Bourbon County,21017,2010,19985,17604,18617,1368
2000, Kentucky,Bourbon County,21017,2000,19360,17497,18857,503
2020, Kentucky,Daviess County,21059,2020,103312,88425,99167,4145
2010, Kentucky,McLean County,21149,2010,9531,9302,9425,106
2000, Kentucky,McLean County,21149,2000,9938,9797,9855,83
2010, Kentucky,Lincoln County,21137,2010,24742,23555,24370,372
2020, Kentucky,Lincoln County,21137,2020,24275,22671,23800,475
2000, Kentucky,Lincoln County,21137,2000,23361,22454,23153,208
2010, Kentucky,Daviess County,21059,2010,96656,88134,94131,2525
2020, Kentucky,Boone County,21015,2020,135968,114457,128261,7707
2020, Kentucky,Boyd County,21019,2020,48261,44282,47547,714
2010, Kentucky,Boyd County,21019,2010,49542,46901,48828,714
2010, Kentucky,Powell County,21197,2010,12613,12321,12481,132
2020, Kentucky,Powell County,21197,2020,13129,12559,12932,197
2000, Kentucky,Powell County,21197,2000,13237,13046,13149,88
2000, Kentucky,Clay County,21051,2000,24556,23063,24223,333
2020, Kentucky,Clay County,21051,2020,20345,18891,19992,353
2020, Kentucky,Boyle County,21021,2020,30614,25365,29124,1490
2010, Kentucky,Clay County,21051,2010,21730,20464,21328,402
2000, Kentucky,Greenup County,21089,2000,36891,36179,36687,204
2020, Kentucky,Greenup County,21089,2020,35962,34096,35645,317
2010, Kentucky,Greenup County,21089,2010,36910,35928,36626,284
2000, Kentucky,Boyle County,21021,2000,27697,24311,27299,398
2010, Kentucky,Boyle County,21021,2010,28432,25086,27636,796
2010, Kentucky,Bracken County,21023,2010,8488,8300,8392,96
2000, Kentucky,Boyd County,21019,2000,49752,47747,49194,558
2000, Kentucky,Larue County,21123,2000,13373,12657,13233,140
2000, Kentucky,Robertson County,21201,2000,2266,2235,2245,21
2010, Kentucky,Nicholas County,21181,2010,7135,6983,7037,98
2020, Kentucky,Pike County,21195,2020,58669,55974,57974,695
2000, Kentucky,Wolfe County,21237,2000,7065,7011,7029,36
2020, Kentucky,Wolfe County,21237,2020,6562,6383,6501,61
2000, Kentucky,Lewis County,21135,2000,14092,13940,14030,62
2010, Kentucky,Lewis County,21135,2010,13870,13711,13792,78
2020, Kentucky,Lewis County,21135,2020,13080,12633,12997,83
2020, Kentucky,Nelson County,21179,2020,46738,41500,45524,1214
2000, Kentucky,Hancock County,21091,2000,8392,8222,8328,64
2010, Kentucky,Hancock County,21091,2010,8565,8331,8471,94
2020, Kentucky,Hancock County,21091,2020,9095,8624,8933,162
2000, Kentucky,Nelson County,21179,2000,37477,34792,37082,395
2020, Kentucky,Kenton County,21117,2020,169064,143992,161323,7741
2010, Kentucky,Pike County,21195,2010,65024,63718,64578,446
2020, Kentucky,Ballard County,21007,2020,7728,7103,7635,93
2020, Kentucky,Robertson County,21201,2020,2193,2112,2174,19
2000, Kentucky,Hopkins County,21107,2000,46519,42808,46096,423
2010, Kentucky,Taylor County,21217,2010,24512,22539,24079,433
2020, Kentucky,Hopkins County,21107,2020,45423,39331,44297,1126
2010, Kentucky,Hopkins County,21107,2010,46920,42289,46186,734
2000, Kentucky,Clark County,21049,2000,33144,31023,32751,393
2010, Kentucky,Ballard County,21007,2010,8249,7808,8159,90
2000, Kentucky,Ballard County,21007,2000,8286,7898,8234,52
2020, Kentucky,Clark County,21049,2020,36972,32555,35495,1477
2000, Kentucky,Meade County,21163,2000,26349,24339,25782,567
2010, Kentucky,Clark County,21049,2010,35613,32833,34722,891
2010, Kentucky,Meade County,21163,2010,28602,26427,27743,859
2020, Kentucky,Meade County,21163,2020,30003,26321,28870,1133
2000, Kentucky,Nicholas County,21181,2000,6813,6698,6776,37
2020, Kentucky,Taylor County,21217,2020,26023,22938,25303,720
2020, Kentucky,Nicholas County,21181,2020,7537,7178,7383,154
2000, Kentucky,Taylor County,21217,2000,22927,21465,22738,189
2020, Kentucky,McLean County,21149,2020,9152,8737,8988,164
2000, Kentucky,Grant County,21081,2000,22384,22006,22152,232
2020, Kentucky,Washington County,21229,2020,12027,10538,11557,470
2020, Kentucky,Campbell County,21037,2020,93076,83361,90767,2309
2000, Kentucky,Marshall County,21157,2000,30125,29694,29896,229
2010, Kentucky,Oldham County,21185,2010,60316,54904,58183,2133
2020, Kentucky,Oldham County,21185,2020,67607,58537,64372,3235
2000, Kentucky,Oldham County,21185,2000,46178,43230,45576,602
2010, Kentucky,Franklin County,21073,2010,49285,41614,47911,1374
2000, Kentucky,Franklin County,21073,2000,47687,41953,47156,531
2020, Kentucky,Franklin County,21073,2020,51541,41736,49494,2047
2020, Kentucky,Caldwell County,21033,2020,12649,11244,12451,198
2010, Kentucky,Caldwell County,21033,2010,12984,12044,12855,129
2000, Kentucky,Caldwell County,21033,2000,13060,12262,12980,80
2000, Kentucky,Gallatin County,21077,2000,7870,7612,7788,82
2020, Kentucky,Gallatin County,21077,2020,8690,7862,8198,492
2010, Kentucky,Gallatin County,21077,2010,8589,8132,8217,372
2020, Kentucky,Owsley County,21189,2020,4051,3905,4009,42
2010, Kentucky,Campbell County,21037,2010,90336,85215,88841,1495
2000, Kentucky,Campbell County,21037,2000,88616,85636,87851,765
2010, Kentucky,Carter County,21043,2010,27720,27101,27399,321
2000, Kentucky,Carter County,21043,2000,26889,26625,26731,158
2020, Kentucky,Spencer County,21215,2020,19490,17910,19040,450
2020, Kentucky,Montgomery County,21173,2020,28114,25566,27189,925
2020, Kentucky,Ohio County,21183,2020,23772,22070,22779,993
2000, Kentucky,Union County,21225,2000,15637,13297,15393,244
2000, Kentucky,Montgomery County,21173,2000,22554,21442,22295,259
2000, Kentucky,Adair County,21001,2000,17244,16555,17112,132
2010, Kentucky,Adair County,21001,2010,18656,17696,18337,319
2010, Kentucky,Owsley County,21189,2010,4755,4692,4716,39
2020, Kentucky,Garrard County,21079,2020,16953,15581,16502,451
2020, Kentucky,Adair County,21001,2020,18903,17322,18260,643
2010, Kentucky,Garrard County,21079,2010,16912,16118,16509,403
2000, Kentucky,Russell County,21207,2000,16315,16044,16175,140
2020, Kentucky,Russell County,21207,2020,17991,16733,17210,781
2010, Kentucky,Russell County,21207,2010,17565,16943,16980,585
2000, Kentucky,Webster County,21233,2000,14120,13220,13852,268
2020, Kentucky,Carter County,21043,2020,26627,25560,26373,254
2000, Kentucky,Garrard County,21079,2000,14792,14163,14597,195
2010, Kentucky,Spencer County,21215,2010,17061,16419,16822,239
2000, Kentucky,Owsley County,21189,2000,4858,4820,4823,35
2000, Kentucky,Calloway County,21035,2000,34177,31950,33704,473
2010, Kentucky,Owen County,21187,2010,10841,10470,10595,246
2010, Kentucky,Casey County,21045,2010,15955,15505,15577,378
2020, Kentucky,Johnson County,21115,2020,22680,21933,22482,198
2010, Kentucky,Johnson County,21115,2010,23356,22976,23247,109
2010, Kentucky,Trimble County,21223,2010,8809,8492,8586,223
2000, Kentucky,Johnson County,21115,2000,23445,23126,23302,143
2020, Kentucky,Trimble County,21223,2020,8474,7992,8282,192
2010, Kentucky,Warren County,21227,2010,113792,95167,108618,5174
2000, Kentucky,Warren County,21227,2000,92522,80474,90056,2466
2000, Kentucky,Trimble County,21223,2000,8125,7954,8014,111
2010, Kentucky,Trigg County,21221,2010,14339,12781,14164,175
2010, Kentucky,Estill County,21065,2010,14672,14457,14571,101
2020, Kentucky,Estill County,21065,2020,14163,13666,14032,131
2000, Kentucky,Estill County,21065,2000,15307,15165,15226,81
2010, Kentucky,Marshall County,21157,2010,31448,30900,31098,350
2020, Kentucky,Owen County,21187,2020,11278,10550,11027,251
2020, Kentucky,Fulton County,21075,2020,6515,4599,6364,151
2010, Kentucky,Fulton County,21075,2010,6813,5004,6760,53
2000, Kentucky,Fulton County,21075,2000,7752,5823,7696,56
2020, Kentucky,Casey County,21045,2020,15941,14974,15402,539
2000, Kentucky,Casey County,21045,2000,15447,15184,15249,198
2020, Kentucky,Calloway County,21035,2020,37103,32626,35750,1353
2020, Kentucky,Trigg County,21221,2020,14061,12309,13744,317
2000, Kentucky,Trigg County,21221,2000,12597,11128,12484,113
2010, Kentucky,Calloway County,21035,2010,37191,34208,36301,890
2010, Kentucky,Magoffin County,21153,2010,13333,13149,13238,95
2000, Kentucky,Owen County,21187,2000,10547,10234,10442,105
2000, Kentucky,Magoffin County,21153,2000,13332,13238,13276,56
2000, Kentucky,Madison County,21151,2000,70872,65918,70187,685
2020, Kentucky,Madison County,21151,2020,92701,80557,89637,3064
2010, Kentucky,Madison County,21151,2010,82916,75926,81103,1813
2010, Kentucky,Jessamine County,21113,2010,48586,45147,47233,1353
2020, Kentucky,Jessamine County,21113,2020,52991,45878,50607,2384
2000, Kentucky,Jessamine County,21113,2000,39041,36871,38529,512
2020, Kentucky,Warren County,21227,2020,134554,99453,125113,9441
2020, Kentucky,Magoffin County,21153,2020,11637,11360,11571,66
2010, Kentucky,Montgomery County,21173,2010,26499,25031,25839,660
2020, Kentucky,Marshall County,21157,2020,31659,29908,31120,539
2010, Kentucky,Union County,21225,2010,15007,12824,14764,243
2020, Kentucky,Floyd County,21071,2020,35942,34828,35634,308
2010, Kentucky,Floyd County,21071,2010,39451,38732,39232,219
2010, Kentucky,Lyon County,21143,2010,8314,7729,8237,77
2020, Kentucky,Martin County,21159,2020,11287,10259,10997,290
2020, Kentucky,Fleming County,21069,2020,15082,14381,14864,218
2010, Kentucky,Martin County,21159,2010,12929,11889,12541,388
2020, Kentucky,Lyon County,21143,2020,8680,7772,8528,152
2000, Kentucky,Monroe County,21171,2000,11756,11235,11586,170
2010, Kentucky,Monroe County,21171,2010,10963,10431,10674,289
2010, Kentucky,Rowan County,21205,2010,23333,22420,23039,294
2020, Kentucky,Rowan County,21205,2020,24662,22914,24121,541
2000, Kentucky,Fayette County,21067,2000,260512,211120,251951,8561
2010, Kentucky,Knott County,21119,2010,16346,16067,16247,99
2020, Kentucky,Fayette County,21067,2020,322570,220236,292820,29750
2020, Kentucky,Knott County,21119,2020,14251,13861,14161,90
2010, Kentucky,Jefferson County,21111,2010,741096,538714,708554,32542
2000, Kentucky,Jefferson County,21111,2000,693604,536721,681234,12370
2020, Kentucky,Crittenden County,21055,2020,8990,8559,8877,113
2010, Kentucky,Fleming County,21069,2010,14348,13920,14199,149
2000, Kentucky,Crittenden County,21055,2000,9384,9219,9336,48
2020, Kentucky,Union County,21225,2020,13668,11873,13480,188
2010, Kentucky,Crittenden County,21055,2010,9315,9105,9267,48
2010, Kentucky,Knox County,21121,2010,31883,30967,31613,270
2010, Kentucky,Butler County,21031,2010,12690,12303,12368,322
2000, Kentucky,Rowan County,21205,2000,22094,21205,21859,235
2000, Kentucky,Knox County,21121,2000,31795,31108,31615,180
2020, Kentucky,Knox County,21121,2020,30193,28616,29846,347
2000, Kentucky,Carroll County,21041,2000,10155,9663,9825,330
2010, Kentucky,Fayette County,21067,2010,295803,223999,275329,20474
2000, Kentucky,Knott County,21119,2000,17649,17344,17537,112
2020, Kentucky,Jefferson County,21111,2020,782969,499868,723948,59021
2010, Kentucky,Carroll County,21041,2010,10811,9955,10022,789
2000, Kentucky,Lyon County,21143,2000,8080,7422,8021,59
2000, Kentucky,Fleming County,21069,2000,13792,13424,13689,103
2010, Kentucky,Carlisle County,21039,2010,5104,4961,5021,83
2010, Kentucky,Washington County,21229,2010,11717,10643,11324,393
2020, Kentucky,Monroe County,21171,2020,11338,10489,10865,473
2000, Kentucky,Carlisle County,21039,2000,5351,5232,5307,44
2010, Kentucky,Ohio County,21183,2010,23842,22944,22998,844
2020, Kentucky,Carlisle County,21039,2020,4826,4531,4693,133
2010, Kentucky,Webster County,21233,2010,13621,12449,13041,580
2000, Kentucky,Ohio County,21183,2000,22916,22391,22685,231
2000, Kentucky,Spencer County,21215,2000,11766,11472,11634,132
2020, Kentucky,Webster County,21233,2020,13017,11440,12172,845
2000, Kentucky,Martin County,21159,2000,12578,12484,12500,78
2000, Kentucky,Kenton County,21117,2000,151464,142357,149795,1669
2020, Kentucky,Carroll County,21041,2020,10810,9567,10015,795
2020, Kentucky,Butler County,21031,2020,12371,11464,11779,592
2010, Kentucky,Marion County,21155,2010,19820,17454,19338,482
2000, Kentucky,Washington County,21229,2000,10916,9892,10741,175
2000, Kentucky,Floyd County,21071,2000,42441,41478,42181,260
2000, Kentucky,Marion County,21155,2000,18212,16240,18068,144
2020, Kentucky,Marion County,21155,2020,19581,16948,18900,681
2000, Kentucky,Butler County,21031,2000,13010,12734,12875,135
2010, Louisiana,Bossier Parish,22015,2010,116979,84430,109953,7026
2010, Louisiana,Lincoln Parish,22061,2010,46735,25775,45546,1189
2020, Louisiana,Richland Parish,22083,2020,20043,11785,19643,400
2000, Louisiana,Plaquemines Parish,22075,2000,26757,18668,26324,433
2020, Louisiana,Tensas Parish,22107,2020,4147,1744,4080,67
2000, Louisiana,St. James Parish,22093,2000,21216,10606,21086,130
2000, Louisiana,Tensas Parish,22107,2000,6618,2874,6535,83
2000, Louisiana,Winn Parish,22127,2000,16894,11195,16747,147
2020, Louisiana,Plaquemines Parish,22075,2020,23515,14287,21279,2236
2000, Louisiana,Richland Parish,22083,2000,20981,12791,20754,227
2010, Louisiana,Winn Parish,22127,2010,15313,10223,15073,240
2010, Louisiana,Ouachita Parish,22073,2010,153720,92884,150960,2760
2000, Louisiana,St. Helena Parish,22091,2000,10525,4897,10421,104
2010, Louisiana,Evangeline Parish,22039,2010,33984,23439,33208,776
2010, Louisiana,Plaquemines Parish,22075,2010,23042,16246,21975,1067
2000, Louisiana,Beauregard Parish,22011,2000,32986,27790,32518,468
2010, Louisiana,Franklin Parish,22041,2010,20767,13930,20571,196
2020, Louisiana,Franklin Parish,22041,2020,19774,12492,19498,276
2020, Louisiana,Bossier Parish,22015,2020,128746,81052,118509,10237
2000, Louisiana,Bossier Parish,22015,2000,98310,73403,95247,3063
2000, Louisiana,Franklin Parish,22041,2000,21263,14281,21103,160
2010, Louisiana,Beauregard Parish,22011,2010,35654,29321,34651,1003
2000, Louisiana,Evangeline Parish,22039,2000,35434,24951,35066,368
2020, Louisiana,Beauregard Parish,22011,2020,36549,29529,35278,1271
2020, Louisiana,St. Bernard Parish,22087,2020,43764,24497,37754,6010
2020, Louisiana,West Feliciana Parish,22125,2020,15310,10883,14659,651
2000, Louisiana,West Feliciana Parish,22125,2000,15111,7348,14954,157
2010, Louisiana,West Feliciana Parish,22125,2010,15625,8125,15374,251
2010, Louisiana,West Carroll Parish,22123,2010,11604,9497,11305,299
2020, Louisiana,West Carroll Parish,22123,2020,9751,7894,9426,325
2000, Louisiana,West Carroll Parish,22123,2000,12314,9838,12148,166
2010, Louisiana,St. Bernard Parish,22087,2010,35897,26579,32588,3309
2010, Louisiana,Richland Parish,22083,2010,20725,12879,20393,332
2000, Louisiana,Lafourche Parish,22057,2000,89974,74544,88690,1284
2000, Louisiana,St. Bernard Parish,22087,2000,67229,59356,63804,3425
2000, Louisiana,Madison Parish,22065,2000,13728,5197,13440,288
2020, Louisiana,Terrebonne Parish,22109,2020,109580,69934,102222,7358
2010, Louisiana,Madison Parish,22065,2010,12093,4498,11905,188
2000, Louisiana,Terrebonne Parish,22109,2000,104503,77401,102872,1631
2010, Louisiana,Terrebonne Parish,22109,2010,111860,78591,107439,4421
2010, Louisiana,Tensas Parish,22107,2010,5252,2202,5187,65
2020, Louisiana,Ouachita Parish,22073,2020,160368,88545,154710,5658
2020, Louisiana,Lincoln Parish,22061,2020,48396,26034,46642,1754
2000, Louisiana,Lincoln Parish,22061,2000,42509,24409,42017,492
2000, Louisiana,Ouachita Parish,22073,2000,147250,94947,145503,1747
2020, Louisiana,Evangeline Parish,22039,2020,32350,21354,31014,1336
2020, Louisiana,Madison Parish,22065,2020,10017,3475,9813,204
2010, Louisiana,St. James Parish,22093,2010,22102,10615,21846,256
2010, Louisiana,Lafourche Parish,22057,2010,96318,76445,92671,3647
2020, Louisiana,St. Tammany Parish,22103,2020,264570,196641,243726,20844
2010, Louisiana,West Baton Rouge Parish,22121,2010,23788,14271,23244,544
2000, Louisiana,Washington Parish,22117,2000,43926,29614,43592,334
2020, Louisiana,St. Landry Parish,22097,2020,82540,43611,80362,2178
2020, Louisiana,Concordia Parish,22029,2020,18687,10275,18228,459
2000, Louisiana,Concordia Parish,22029,2000,20247,12300,19947,300
2010, Louisiana,Vernon Parish,22115,2010,52334,39614,48559,3775
2000, Louisiana,Webster Parish,22119,2000,41831,27405,41453,378
2010, Louisiana,Washington Parish,22117,2010,47168,31482,46281,887
2000, Louisiana,St. Landry Parish,22097,2000,87700,49555,86906,794
2020, Louisiana,Webster Parish,22119,2020,36967,22735,36279,688
2020, Louisiana,Claiborne Parish,22027,2020,14170,7263,13691,479
2010, Louisiana,St. Landry Parish,22097,2010,83384,46615,82063,1321
2020, Louisiana,Cameron Parish,22023,2020,5617,5232,5420,197
2000, Louisiana,Cameron Parish,22023,2000,9991,9357,9776,215
2010, Louisiana,Cameron Parish,22023,2010,6839,6546,6685,154
2000, Louisiana,Tangipahoa Parish,22105,2000,100588,70175,99052,1536
2010, Louisiana,Webster Parish,22119,2010,41207,26469,40537,670
2010, Louisiana,Tangipahoa Parish,22105,2010,121097,80206,116837,4260
2010, Louisiana,Concordia Parish,22029,2010,20822,11959,20613,209
2020, Louisiana,Vernon Parish,22115,2020,48750,35087,44575,4175
2010, Louisiana,Orleans Parish,22071,2010,343829,113428,325778,18051
2000, Louisiana,Orleans Parish,22071,2000,484674,135956,469848,14826
2020, Louisiana,Pointe Coupee Parish,22077,2020,20758,12395,20133,625
2010, Louisiana,Pointe Coupee Parish,22077,2010,22802,14010,22310,492
2020, Louisiana,Orleans Parish,22071,2020,383997,126462,352980,31017
2010, Louisiana,Claiborne Parish,22027,2010,17195,8167,17024,171
2010, Louisiana,Rapides Parish,22079,2010,131613,83373,128195,3418
2000, Louisiana,Claiborne Parish,22027,2000,16851,8728,16723,128
2010, Louisiana,Acadia Parish,22001,2010,61773,49127,60713,1060
2000, Louisiana,St. John the Baptist Parish,22095,2000,43044,22633,41814,1230
2020, Louisiana,St. Helena Parish,22091,2020,10920,4527,10704,216
2010, Louisiana,St. Helena Parish,22091,2010,11203,5034,11104,99
2000, Louisiana,Rapides Parish,22079,2000,126337,84024,124598,1739
2000, Louisiana,Vernon Parish,22115,2000,52531,38717,49420,3111
2020, Louisiana,Acadia Parish,22001,2020,57576,44480,55935,1641
2010, Louisiana,Bienville Parish,22013,2010,14353,7935,14146,207
2010, Louisiana,St. John the Baptist Parish,22095,2010,45924,19501,43749,2175
2000, Louisiana,Pointe Coupee Parish,22077,2000,22763,13865,22518,245
2000, Louisiana,St. Mary Parish,22101,2000,53500,33591,52348,1152
2010, Louisiana,St. Mary Parish,22101,2010,54650,32406,51730,2920
2020, Louisiana,Avoyelles Parish,22009,2020,39693,25625,38208,1485
2020, Louisiana,St. Mary Parish,22101,2020,49406,26949,44882,4524
2010, Louisiana,Avoyelles Parish,22009,2010,42073,28188,41467,606
2000, Louisiana,Avoyelles Parish,22009,2000,41481,28402,41077,404
2020, Louisiana,St. Martin Parish,22099,2020,51767,33259,50088,1679
2020, Louisiana,St. James Parish,22093,2020,20192,9973,19849,343
2000, Louisiana,Acadia Parish,22001,2000,58861,47521,58323,538
2000, Louisiana,West Baton Rouge Parish,22121,2000,21601,13561,21288,313
2000, Louisiana,Natchitoches Parish,22069,2000,39080,22608,38514,566
2020, Louisiana,Winn Parish,22127,2020,13755,8594,12732,1023
2010, Louisiana,Natchitoches Parish,22069,2010,39566,21494,38831,735
2000, Louisiana,St. Tammany Parish,22103,2000,191268,166458,186531,4737
2020, Louisiana,Natchitoches Parish,22069,2020,37515,19361,36025,1490
2010, Louisiana,St. Martin Parish,22099,2010,52160,34313,51089,1071
2000, Louisiana,St. Martin Parish,22099,2000,48583,32040,48178,405
2020, Louisiana,St. John the Baptist Parish,22095,2020,42477,13877,39186,3291
2020, Louisiana,Rapides Parish,22079,2020,130023,77510,124933,5090
2000, Louisiana,Bienville Parish,22013,2000,15752,8651,15603,149
2020, Louisiana,Bienville Parish,22013,2020,12981,6950,12770,211
2000, Louisiana,De Soto Parish,22031,2000,25494,14269,25098,396
2020, Louisiana,De Soto Parish,22031,2020,26812,15284,26050,762
2000, Louisiana,Vermilion Parish,22113,2000,53807,44488,53065,742
2010, Louisiana,Vermilion Parish,22113,2010,57999,46922,56618,1381
2020, Louisiana,Vermilion Parish,22113,2020,57359,44477,55063,2296
2010, Louisiana,De Soto Parish,22031,2010,26656,15456,25995,661
2010, Louisiana,Red River Parish,22081,2010,9091,5360,8990,101
2000, Louisiana,Red River Parish,22081,2000,9622,5568,9525,97
2020, Louisiana,Red River Parish,22081,2020,7620,4195,7432,188
2000, Louisiana,St. Charles Parish,22089,2000,48072,34803,46726,1346
2020, Louisiana,St. Charles Parish,22089,2020,52549,33550,48408,4141
2010, Louisiana,St. Charles Parish,22089,2010,52780,36540,50132,2648
2020, Louisiana,Washington Parish,22117,2020,45463,29943,44053,1410
2020, Louisiana,Tangipahoa Parish,22105,2020,133157,81336,125915,7242
2020, Louisiana,West Baton Rouge Parish,22121,2020,27199,14307,25955,1244
2000, Louisiana,Caddo Parish,22017,2000,252161,133424,248411,3750
2020, Louisiana,Grant Parish,22043,2020,22169,17709,20836,1333
2010, Louisiana,Sabine Parish,22085,2010,24233,17155,23413,820
2020, Louisiana,Allen Parish,22003,2020,22750,16327,20857,1893
2010, Louisiana,East Baton Rouge Parish,22033,2010,440171,214927,423897,16274
2000, Louisiana,East Baton Rouge Parish,22033,2000,412852,231886,405489,7363
2020, Louisiana,East Baton Rouge Parish,22033,2020,456781,196069,426230,30551
2020, Louisiana,East Carroll Parish,22035,2020,7459,2054,7344,115
2010, Louisiana,La Salle Parish,22059,2010,14890,12689,14559,331
2000, Louisiana,La Salle Parish,22059,2000,14282,12301,14165,117
2010, Louisiana,St. Tammany Parish,22103,2010,233740,195364,222770,10970
2000, Louisiana,Union Parish,22111,2000,22803,15914,22342,461
2020, Louisiana,Union Parish,22111,2020,21107,14460,19972,1135
2000, Louisiana,Calcasieu Parish,22019,2000,183577,135107,181114,2463
2000, Louisiana,East Carroll Parish,22035,2000,9421,2977,9309,112
2010, Louisiana,East Carroll Parish,22035,2010,7759,2245,7632,127
2020, Louisiana,Caldwell Parish,22021,2020,9645,7646,9424,221
2010, Louisiana,Caldwell Parish,22021,2010,10132,8213,9910,222
2000, Louisiana,Sabine Parish,22085,2000,23459,17048,22817,642
2000, Louisiana,Grant Parish,22043,2000,18698,15973,18485,213
2010, Louisiana,Caddo Parish,22017,2010,254969,124942,248840,6129
2020, Louisiana,LaSalle Parish,22059,2020,14791,11348,13389,1402
2020, Louisiana,Sabine Parish,22085,2020,22155,15036,21445,710
2010, Louisiana,Livingston Parish,22063,2010,128026,117601,124225,3801
2000, Louisiana,Morehouse Parish,22067,2000,31021,17297,30791,230
2020, Louisiana,Livingston Parish,22063,2020,142282,116855,133491,8791
2000, Louisiana,Livingston Parish,22063,2000,91814,86625,90797,1017
2010, Louisiana,Union Parish,22111,2010,22721,15682,21778,943
2020, Louisiana,Jackson Parish,22049,2020,15031,9967,14563,468
2010, Louisiana,Allen Parish,22003,2010,25764,18435,25422,342
2000, Louisiana,Allen Parish,22003,2000,25440,18291,24294,1146
2010, Louisiana,Grant Parish,22043,2010,22309,18149,21378,931
2020, Louisiana,Morehouse Parish,22067,2020,25629,12281,25248,381
2010, Louisiana,Morehouse Parish,22067,2010,27979,14345,27724,255
2000, Louisiana,Jackson Parish,22049,2000,15397,10934,15303,94
2000, Louisiana,Caldwell Parish,22021,2000,10560,8493,10403,157
2010, Louisiana,Jackson Parish,22049,2010,16274,11084,16065,209
2010, Louisiana,Ascension Parish,22005,2010,107215,78572,102191,5024
2020, Louisiana,Calcasieu Parish,22019,2020,216785,139772,205401,11384
2000, Louisiana,East Feliciana Parish,22037,2000,21360,11063,21203,157
2020, Louisiana,Iberville Parish,22047,2020,30241,14833,28823,1418
2010, Louisiana,Iberville Parish,22047,2010,33387,16280,32723,664
2010, Louisiana,Catahoula Parish,22025,2010,10407,6985,10317,90
2000, Louisiana,Iberville Parish,22047,2000,33320,16412,32977,343
2020, Louisiana,Catahoula Parish,22025,2020,8906,5776,8292,614
2020, Louisiana,East Feliciana Parish,22037,2020,19539,11516,19148,391
2010, Louisiana,Lafayette Parish,22055,2010,221578,153706,212981,8597
2000, Louisiana,Iberia Parish,22045,2000,73266,47682,72165,1101
2010, Louisiana,Iberia Parish,22045,2010,73240,45551,70941,2299
2020, Louisiana,Assumption Parish,22007,2020,21039,13722,20125,914
2010, Louisiana,Calcasieu Parish,22019,2010,192768,136514,187823,4945
2020, Louisiana,Lafayette Parish,22055,2020,241753,153363,225770,15983
2000, Louisiana,Jefferson Parish,22051,2000,455466,318002,423048,32418
2010, Louisiana,Jefferson Parish,22051,2010,432552,272115,378850,53702
2020, Louisiana,Iberia Parish,22045,2020,69929,39206,66032,3897
2020, Louisiana,Caddo Parish,22017,2020,237848,103457,229467,8381
2010, Louisiana,Assumption Parish,22007,2010,23421,15635,22923,498
2000, Louisiana,Assumption Parish,22007,2000,23388,15710,23104,284
2010, Louisiana,East Feliciana Parish,22037,2010,20267,10783,20059,208
2020, Louisiana,Jefferson Parish,22051,2020,440781,220935,361724,79057
2010, Louisiana,Jefferson Davis Parish,22053,2010,31594,25125,31056,538
2000, Louisiana,Catahoula Parish,22025,2000,10920,7838,10819,101
2020, Louisiana,Jefferson Davis Parish,22053,2020,32250,25066,31516,734
2000, Louisiana,Jefferson Davis Parish,22053,2000,31435,25337,31123,312
2000, Louisiana,Ascension Parish,22005,2000,76627,59304,74744,1883
2020, Louisiana,Lafourche Parish,22057,2020,97557,71710,91885,5672
2020, Louisiana,Ascension Parish,22005,2020,126500,81141,116117,10383
2000, Louisiana,Lafayette Parish,22055,2000,190503,139758,187183,3320
2010, Maine,Kennebec County,23011,2010,122151,117501,120647,1504
2010, Maine,Cumberland County,23005,2010,281674,261396,276629,5045
2000, Maine,Aroostook County,23003,2000,73938,71572,73497,441
2020, Maine,Cumberland County,23005,2020,303069,264408,295058,8011
2000, Maine,Oxford County,23017,2000,54755,53797,54463,292
2020, Maine,Penobscot County,23019,2020,152199,139311,149484,2715
2010, Maine,Oxford County,23017,2010,57833,55990,57246,587
2000, Maine,Penobscot County,23019,2000,144919,139989,144037,882
2020, Maine,Oxford County,23017,2020,57777,53795,56912,865
2020, Maine,Kennebec County,23011,2020,123642,113639,121090,2552
2010, Maine,Hancock County,23009,2010,54418,52741,53824,594
2010, Maine,Penobscot County,23019,2010,153923,146802,152303,1620
2020, Maine,Hancock County,23009,2020,55478,51444,54509,969
2010, Maine,Piscataquis County,23021,2010,17535,17000,17366,169
2000, Maine,Androscoggin County,23001,2000,103793,100658,102805,988
2010, Maine,Androscoggin County,23001,2010,107702,99939,106033,1669
2020, Maine,Androscoggin County,23001,2020,111139,96625,108917,2222
2010, Maine,Sagadahoc County,23023,2010,35293,33969,34840,453
2000, Maine,Hancock County,23009,2000,51791,50554,51455,336
2010, Maine,Aroostook County,23003,2010,71870,68759,71203,667
2000, Maine,Sagadahoc County,23023,2000,35214,33977,34823,391
2010, Maine,Franklin County,23007,2010,30768,29952,30453,315
2020, Maine,Franklin County,23007,2020,29456,27356,29049,407
2000, Maine,Franklin County,23007,2000,29467,28865,29308,159
2020, Maine,Sagadahoc County,23023,2020,36699,34046,36050,649
2000, Maine,Kennebec County,23011,2000,117114,114129,116262,852
2000, Maine,Cumberland County,23005,2000,265612,254291,263086,2526
2020, Maine,Aroostook County,23003,2020,67105,62521,66193,912
2000, Maine,Waldo County,23027,2000,36280,35513,36065,215
2020, Maine,Knox County,23013,2020,40607,37713,39935,672
2000, Maine,Knox County,23013,2000,39618,38935,39393,225
2010, Maine,Knox County,23013,2010,39736,38579,39399,337
2010, Maine,Lincoln County,23015,2010,34457,33636,34170,287
2020, Maine,Lincoln County,23015,2020,35237,33215,34842,395
2000, Maine,Lincoln County,23015,2000,33616,33099,33461,155
2000, Maine,Somerset County,23025,2000,50888,49868,50654,234
2020, Maine,Somerset County,23025,2020,50477,47184,49821,656
2010, Maine,Waldo County,23027,2010,38786,37673,38437,349
2010, Maine,Somerset County,23025,2010,52228,50733,51819,409
2020, Maine,Waldo County,23027,2020,39607,37097,39048,559
2020, Maine,Piscataquis County,23021,2020,16800,15572,16539,261
2000, Maine,York County,23031,2000,186742,182177,185441,1301
2020, Maine,York County,23031,2020,211972,195326,207875,4097
2000, Maine,Piscataquis County,23021,2000,17235,16862,17146,89
2010, Maine,Washington County,23029,2010,32856,30257,32404,452
2000, Maine,Washington County,23029,2000,33941,31728,33667,274
2010, Maine,York County,23031,2010,197131,190044,194653,2478
2020, Maine,Washington County,23029,2020,31095,27789,30428,667
2000, Maryland,Baltimore County,24005,2000,754292,561132,740518,13774
2010, Maryland,Charles County,24017,2010,146551,73677,140292,6259
2000, Maryland,Queen Anne's County,24035,2000,40563,36120,40119,444
2020, Maryland,Worcester County,24047,2020,52460,41845,50382,2078
2020, Maryland,Baltimore County,24005,2020,854535,452124,793043,61492
2000, Maryland,Anne Arundel County,24003,2000,489656,397789,476754,12902
2010, Maryland,Talbot County,24041,2010,37782,30746,35709,2073
2000, Maryland,Talbot County,24041,2000,33812,27720,33197,615
2020, Maryland,Talbot County,24041,2020,37526,28436,34174,3352
2020, Maryland,Washington County,24043,2020,154705,117465,144416,10289
2010, Maryland,St. Mary's County,24037,2010,105151,82636,101179,3972
2010, Maryland,Baltimore County,24005,2010,805029,520185,771294,33735
2020, Maryland,Baltimore city,24510,2020,585708,163026,539781,45927
2010, Maryland,Baltimore city,24510,2010,620961,183830,595001,25960
2000, Maryland,Charles County,24017,2000,120546,82587,117824,2722
2000, Maryland,Somerset County,24039,2000,24747,13949,24413,334
2000, Maryland,Allegany County,24001,2000,74930,69702,74359,571
2010, Maryland,Wicomico County,24045,2010,98733,67784,94255,4478
2020, Maryland,Charles County,24017,2020,166617,58587,154940,11677
2020, Maryland,Queen Anne's County,24035,2020,49874,42290,47336,2538
2000, Maryland,Worcester County,24047,2000,46543,37791,45947,596
2010, Maryland,Montgomery County,24031,2010,971777,558358,806379,165398
2010, Maryland,Queen Anne's County,24035,2010,47798,42397,46346,1452
2010, Maryland,Anne Arundel County,24003,2010,537656,405456,504754,32902
2000, Maryland,Washington County,24043,2000,131923,118348,130353,1570
2020, Maryland,Anne Arundel County,24003,2020,588261,377634,531465,56796
2000, Maryland,Baltimore city,24510,2000,651154,205982,640093,11061
2010, Maryland,Dorchester County,24019,2010,32618,22065,31488,1130
2020, Maryland,Carroll County,24013,2020,172891,148621,165146,7745
2010, Maryland,Carroll County,24013,2010,167134,155282,162771,4363
2020, Maryland,Prince George's County,24033,2020,967201,124863,761738,205463
2020, Maryland,Harford County,24025,2020,260924,190128,246917,14007
2020, Maryland,Howard County,24027,2020,332317,159329,304955,27362
2010, Maryland,Howard County,24027,2010,287085,178523,270356,16729
2000, Maryland,Howard County,24027,2000,247842,184215,240352,7490
2020, Maryland,Calvert County,24009,2020,92783,69935,88581,4202
2000, Maryland,Calvert County,24009,2000,74563,62578,73428,1135
2010, Maryland,Kent County,24029,2010,20197,16169,19290,907
2000, Maryland,Kent County,24029,2000,19197,15288,18651,546
2020, Maryland,Kent County,24029,2020,19198,14574,18137,1061
2000, Maryland,Caroline County,24011,2000,29772,24322,28983,789
2020, Maryland,Caroline County,24011,2020,33293,24479,30473,2820
2010, Maryland,Caroline County,24011,2010,33066,26396,31250,1816
2010, Maryland,Allegany County,24001,2010,75087,66981,74002,1085
2020, Maryland,Allegany County,24001,2020,68106,58377,66957,1149
2000, Maryland,St. Mary's County,24037,2000,86211,70320,84491,1720
2020, Maryland,St. Mary's County,24037,2020,113777,81952,107232,6545
2020, Maryland,Dorchester County,24019,2020,32531,20128,30754,1777
2000, Maryland,Dorchester County,24019,2000,30674,21302,30289,385
2000, Maryland,Prince George's County,24033,2000,801515,216729,744458,57057
2010, Maryland,Prince George's County,24033,2010,863420,166059,734448,128972
2010, Maryland,Calvert County,24009,2010,88737,72231,86300,2437
2010, Maryland,Cecil County,24015,2010,101108,90189,97701,3407
2000, Maryland,Carroll County,24013,2000,150897,144399,149408,1489
2010, Maryland,Frederick County,24021,2010,233385,190306,216250,17135
2010, Maryland,Harford County,24025,2010,244826,198763,236213,8613
2000, Maryland,Harford County,24025,2000,218590,189678,214421,4169
2000, Maryland,Montgomery County,24031,2000,873341,565719,772737,100604
2000, Maryland,Frederick County,24021,2000,195277,174432,190613,4664
2020, Maryland,Montgomery County,24031,2020,1062061,457783,844652,217409
2020, Maryland,Frederick County,24021,2020,271717,189470,239598,32119
2020, Maryland,Cecil County,24015,2020,103725,84806,98275,5450
2000, Maryland,Garrett County,24023,2000,29846,29496,29715,131
2010, Maryland,Worcester County,24047,2010,51454,42194,49832,1622
2010, Maryland,Somerset County,24039,2010,26470,14170,25607,863
2000, Maryland,Cecil County,24015,2000,85951,80272,84645,1306
2000, Maryland,Wicomico County,24045,2000,84644,61438,82802,1842
2020, Maryland,Somerset County,24039,2020,24620,13076,23545,1075
2020, Maryland,Wicomico County,24045,2020,103588,61425,96497,7091
2010, Maryland,Garrett County,24023,2010,30097,29440,29877,220
2010, Maryland,Washington County,24043,2010,147430,125447,142326,5104
2020, Maryland,Garrett County,24023,2020,28806,27521,28485,321
2020, Massachusetts,Worcester County,25027,2020,862111,634240,750209,111902
2020, Massachusetts,Plymouth County,25023,2020,530819,411558,506867,23952
2000, Massachusetts,Barnstable County,25001,2000,222230,209398,219230,3000
2010, Massachusetts,Berkshire County,25003,2010,131219,121384,126689,4530
2000, Massachusetts,Worcester County,25027,2000,750963,672915,700099,50864
2020, Massachusetts,Berkshire County,25003,2020,129026,110862,121962,7064
2020, Massachusetts,Barnstable County,25001,2020,228996,196459,221088,7908
2000, Massachusetts,Berkshire County,25003,2000,134953,128235,132667,2286
2010, Massachusetts,Barnstable County,25001,2010,215888,200194,211201,4687
2000, Massachusetts,Plymouth County,25023,2000,472822,419370,461285,11537
2010, Massachusetts,Plymouth County,25023,2010,494919,423133,479300,15619
2010, Massachusetts,Worcester County,25027,2010,798552,683361,723130,75422
2000, Massachusetts,Dukes County,25007,2000,14987,13592,14832,155
2020, Massachusetts,Franklin County,25011,2020,71029,62398,67437,3592
2000, Massachusetts,Hampshire County,25015,2000,152251,138704,147039,5212
2000, Massachusetts,Hampden County,25013,2000,456228,360889,387031,69197
2010, Massachusetts,Hampden County,25013,2010,463490,354580,366714,96776
2020, Massachusetts,Hampden County,25013,2020,465825,302357,344506,121319
2020, Massachusetts,Essex County,25009,2020,809829,558325,626982,182847
2010, Massachusetts,Middlesex County,25017,2010,1503085,1202411,1404735,98350
2010, Massachusetts,Franklin County,25011,2010,71372,67239,69122,2250
2000, Massachusetts,Franklin County,25011,2000,71535,68244,70110,1425
2020, Massachusetts,Hampshire County,25015,2020,162308,130161,150686,11622
2000, Massachusetts,Middlesex County,25017,2000,1465396,1258476,1398689,66707
2020, Massachusetts,Nantucket County,25019,2020,14255,10159,11943,2312
2010, Massachusetts,Nantucket County,25019,2010,10172,8913,9215,957
2000, Massachusetts,Bristol County,25005,2000,534678,486434,515436,19242
2000, Massachusetts,Nantucket County,25019,2000,9520,8363,9308,212
2010, Massachusetts,Bristol County,25005,2010,548285,484794,515265,33020
2020, Massachusetts,Bristol County,25005,2020,579200,455763,524449,54751
2010, Massachusetts,Essex County,25009,2010,743159,608369,620414,122745
2010, Massachusetts,Suffolk County,25025,2010,722023,404269,578568,143455
2020, Massachusetts,Suffolk County,25025,2020,797936,375467,619409,178527
2010, Massachusetts,Hampshire County,25015,2010,158080,140250,150625,7455
2000, Massachusetts,Suffolk County,25025,2000,689807,398442,582776,107031
2000, Massachusetts,Essex County,25009,2000,723419,625320,643548,79871
2010, Massachusetts,Norfolk County,25021,2010,670850,551847,648846,22004
2020, Massachusetts,Norfolk County,25021,2020,725981,519522,687871,38110
2020, Massachusetts,Dukes County,25007,2020,20600,16321,20066,534
2000, Massachusetts,Norfolk County,25021,2000,650308,578904,638318,11990
2020, Massachusetts,Middlesex County,25017,2020,1632002,1112445,1488757,143245
2010, Massachusetts,Dukes County,25007,2010,16535,14492,16151,384
2010, Michigan,Missaukee County,26113,2010,14849,14419,14543,306
2000, Michigan,Iron County,26071,2000,13138,12649,13054,84
2010, Michigan,Sanilac County,26151,2010,43114,41649,41675,1439
2020, Michigan,Presque Isle County,26141,2020,12982,12342,12828,154
2020, Michigan,Missaukee County,26113,2020,15052,14086,14553,499
2020, Michigan,Alpena County,26007,2020,28907,27177,28490,417
2020, Michigan,Iron County,26071,2020,11631,10930,11425,206
2000, Michigan,Muskegon County,26121,2000,170200,138291,164199,6001
2010, Michigan,Alpena County,26007,2010,29598,28845,29294,304
2010, Michigan,Muskegon County,26121,2010,172188,137679,163927,8261
2010, Michigan,Huron County,26063,2010,33118,32286,32461,657
2000, Michigan,Huron County,26063,2000,36079,35363,35488,591
2000, Michigan,Alpena County,26007,2000,31314,30753,31133,181
2010, Michigan,Iron County,26071,2010,11817,11469,11656,161
2010, Michigan,Allegan County,26005,2010,111408,103513,103954,7454
2000, Michigan,Missaukee County,26113,2000,14478,14116,14309,169
2000, Michigan,Allegan County,26005,2000,105665,98769,99625,6040
2000, Michigan,Midland County,26111,2000,82874,79148,81587,1287
2020, Michigan,Arenac County,26011,2020,15002,14017,14732,270
2020, Michigan,Huron County,26063,2020,31407,29807,30567,840
2020, Michigan,Muskegon County,26121,2020,175824,133720,165541,10283
2020, Michigan,Montmorency County,26119,2020,9153,8619,9028,125
2020, Michigan,Sanilac County,26151,2020,40611,37883,38937,1674
2000, Michigan,Presque Isle County,26141,2000,14411,14133,14332,79
2020, Michigan,Ingham County,26065,2020,284900,198552,260478,24422
2010, Michigan,Ingham County,26065,2010,280895,213913,260369,20526
2000, Michigan,Ingham County,26065,2000,279320,221935,263130,16190
2000, Michigan,Lake County,26085,2000,11333,9595,11142,191
2020, Michigan,Ionia County,26067,2020,66804,58946,63440,3364
2020, Michigan,Delta County,26041,2020,36903,33684,36360,543
2010, Michigan,Ionia County,26067,2010,63905,58563,61114,2791
2000, Michigan,Ionia County,26067,2000,61518,56572,59807,1711
2020, Michigan,Iosco County,26069,2020,25237,23459,24627,610
2000, Michigan,Delta County,26041,2000,38520,36913,38333,187
2010, Michigan,Iosco County,26069,2010,25887,24965,25484,403
2000, Michigan,Iosco County,26069,2000,27339,26496,27070,269
2010, Michigan,Delta County,26041,2010,37069,35118,36751,318
2010, Michigan,Presque Isle County,26141,2010,13376,13050,13260,116
2020, Michigan,Clinton County,26037,2020,79128,69204,75188,3940
2010, Michigan,Alcona County,26001,2010,10942,10712,10818,124
2020, Michigan,Kent County,26081,2020,657974,480003,582746,75228
2010, Michigan,Kent County,26081,2010,602622,481594,544185,58437
2000, Michigan,Kent County,26081,2000,574335,477421,534152,40183
2020, Michigan,Alcona County,26001,2020,10167,9644,10045,122
2020, Michigan,Lake County,26085,2020,12096,10295,10901,1195
2000, Michigan,Sanilac County,26151,2000,44547,43165,43308,1239
2010, Michigan,Lake County,26085,2010,11539,10035,11296,243
2000, Michigan,Alcona County,26001,2000,11719,11489,11638,81
2000, Michigan,Montmorency County,26119,2000,10315,10146,10248,67
2010, Michigan,Montmorency County,26119,2010,9765,9532,9669,96
2010, Michigan,Clare County,26035,2010,30926,29951,30462,464
2020, Michigan,Allegan County,26005,2020,120502,105564,111113,9389
2010, Michigan,Isabella County,26073,2010,70311,62697,68114,2197
2000, Michigan,St. Joseph County,26149,2000,62422,58356,59934,2488
2010, Michigan,St. Joseph County,26149,2010,61295,55519,57261,4034
2000, Michigan,Jackson County,26075,2000,158422,140267,154929,3493
2000, Michigan,Alger County,26003,2000,9862,8660,9763,99
2020, Michigan,St. Joseph County,26149,2020,60939,51530,55512,5427
2010, Michigan,Keweenaw County,26083,2010,2156,2123,2141,15
2000, Michigan,Keweenaw County,26083,2000,2301,2185,2283,18
2010, Michigan,Jackson County,26075,2010,160248,140507,155411,4837
2020, Michigan,Jackson County,26075,2020,160366,133257,154182,6184
2020, Michigan,Keweenaw County,26083,2020,2046,1954,2019,27
2000, Michigan,Lapeer County,26087,2000,87904,84541,85173,2731
2010, Michigan,Lapeer County,26087,2010,88319,84351,84697,3622
2000, Michigan,Baraga County,26013,2000,8746,6875,8665,81
2010, Michigan,Kalamazoo County,26077,2010,250331,204644,240372,9959
2010, Michigan,Alger County,26003,2010,9601,8286,9487,114
2020, Michigan,Kalamazoo County,26077,2020,261670,197010,246894,14776
2010, Michigan,Hillsdale County,26059,2010,46688,45304,45862,826
2000, Michigan,Hillsdale County,26059,2000,46527,45391,45969,558
2000, Michigan,Kalamazoo County,26077,2000,238603,201784,232292,6311
2020, Michigan,Hillsdale County,26059,2020,45746,42658,44574,1172
2020, Michigan,Baraga County,26013,2020,8158,5772,8056,102
2010, Michigan,Baraga County,26013,2010,8860,6641,8774,86
2000, Michigan,Kalkaska County,26079,2000,16571,16163,16429,142
2020, Michigan,Kalkaska County,26079,2020,17939,16671,17584,355
2010, Michigan,Kalkaska County,26079,2010,17153,16602,16939,214
2000, Michigan,Clare County,26035,2000,31252,30427,30912,340
2010, Michigan,Montcalm County,26117,2010,63342,59752,61410,1932
2000, Michigan,Barry County,26015,2000,56755,55276,55924,831
2020, Michigan,Alger County,26003,2020,8842,7363,8727,115
2010, Michigan,Crawford County,26039,2010,14074,13721,13892,182
2000, Michigan,Crawford County,26039,2000,14273,13757,14131,142
2020, Michigan,Isabella County,26073,2020,64394,54159,61388,3006
2000, Michigan,Bay County,26017,2000,110157,104580,105849,4308
2020, Michigan,Bay County,26017,2020,103856,93305,97926,5930
2000, Michigan,Clinton County,26037,2000,64753,62420,63065,1688
2010, Michigan,Clinton County,26037,2010,75382,70018,72435,2947
2020, Michigan,Clare County,26035,2020,30856,28880,30235,621
2020, Michigan,Monroe County,26115,2020,154809,137561,148578,6231
2000, Michigan,Monroe County,26115,2000,145945,139264,142835,3110
2000, Michigan,Isabella County,26073,2000,63351,57970,61932,1419
2010, Michigan,Midland County,26111,2010,83629,79063,81925,1704
2020, Michigan,Midland County,26111,2020,83494,74791,80835,2659
2000, Michigan,Montcalm County,26117,2000,61266,58101,59872,1394
2000, Michigan,Arenac County,26011,2000,17269,16472,17031,238
2010, Michigan,Bay County,26017,2010,107771,101451,102678,5093
2010, Michigan,Houghton County,26061,2010,36628,34596,36213,415
2000, Michigan,Houghton County,26061,2000,36016,34402,35765,251
2010, Michigan,Monroe County,26115,2010,152021,143476,147354,4667
2020, Michigan,Montcalm County,26117,2020,66614,60106,63917,2697
2010, Michigan,Arenac County,26011,2010,15899,15393,15674,225
2010, Michigan,Antrim County,26009,2010,23580,22815,23176,404
2000, Michigan,Antrim County,26009,2000,23110,22419,22826,284
2020, Michigan,St. Clair County,26147,2020,160383,144476,154878,5505
2010, Michigan,St. Clair County,26147,2010,163040,153052,158332,4708
2020, Michigan,Barry County,26015,2020,62423,57488,60281,2142
2000, Michigan,St. Clair County,26147,2000,164235,155962,160642,3593
2010, Michigan,Barry County,26015,2010,59173,57350,57837,1336
2020, Michigan,Antrim County,26009,2020,23431,21902,22972,459
2020, Michigan,Crawford County,26039,2020,12988,12140,12696,292
2020, Michigan,Houghton County,26061,2020,37361,34107,36692,669
2020, Michigan,Lapeer County,26087,2020,88619,80249,84375,4244
2010, Michigan,Leelanau County,26089,2010,21708,20207,20914,794
2020, Michigan,Charlevoix County,26029,2020,26054,24052,25629,425
2020, Michigan,Ogemaw County,26129,2020,20770,19509,20333,437
2020, Michigan,Emmet County,26047,2020,34112,30578,33520,592
2020, Michigan,Saginaw County,26145,2020,190124,133915,173220,16904
2000, Michigan,Chippewa County,26033,2000,38543,29247,37944,599
2000, Michigan,Saginaw County,26145,2000,210039,158220,195964,14075
2010, Michigan,Emmet County,26047,2010,32694,30375,32265,429
2000, Michigan,Emmet County,26047,2000,31437,29655,31152,285
2000, Michigan,Wexford County,26165,2000,30484,29659,30177,307
2010, Michigan,Saginaw County,26145,2010,200169,149272,184596,15573
2020, Michigan,Schoolcraft County,26153,2020,8047,6756,7951,96
2010, Michigan,Schoolcraft County,26153,2010,8485,7432,8421,64
2010, Michigan,Mackinac County,26097,2010,11113,8499,10987,126
2020, Michigan,Mackinac County,26097,2020,10834,8080,10667,167
2000, Michigan,Marquette County,26103,2000,64634,61478,64190,444
2010, Michigan,Otsego County,26137,2010,24164,23413,23865,299
2010, Michigan,Benzie County,26019,2010,17525,16843,17223,302
2020, Michigan,Benzie County,26019,2020,17970,16726,17579,391
2020, Michigan,Branch County,26023,2020,44862,39595,42279,2583
2000, Michigan,Benzie County,26019,2000,15998,15420,15765,233
2020, Michigan,Eaton County,26045,2020,109175,89292,102648,6527
2020, Michigan,Chippewa County,26033,2020,36785,24803,36028,757
2010, Michigan,Chippewa County,26033,2010,38520,27837,38040,480
2010, Michigan,Oscoda County,26135,2010,8640,8437,8561,79
2010, Michigan,Branch County,26023,2010,45248,42055,43444,1804
2020, Michigan,Shiawassee County,26155,2020,68094,63132,66070,2024
2010, Michigan,Eaton County,26045,2010,107759,94561,102658,5101
2000, Michigan,Otsego County,26137,2000,23301,22720,23126,175
2010, Michigan,Manistee County,26101,2010,24733,22811,24099,634
2010, Michigan,Wexford County,26165,2010,32735,31590,32216,519
2020, Michigan,Lenawee County,26091,2020,99423,86549,90929,8494
2010, Michigan,Lenawee County,26091,2010,99892,92174,92278,7614
2020, Michigan,Dickinson County,26043,2020,25947,24379,25507,440
2020, Michigan,Wexford County,26165,2020,33673,31124,32883,790
2000, Michigan,Dickinson County,26043,2000,27472,26909,27285,187
2010, Michigan,Dickinson County,26043,2010,26168,25438,25898,270
2000, Michigan,Eaton County,26045,2000,103655,93549,100332,3323
2000, Michigan,Mackinac County,26097,2000,11943,9563,11836,107
2010, Michigan,Macomb County,26099,2010,840978,717973,821883,19095
2010, Michigan,Berrien County,26021,2010,156813,122804,149759,7054
2000, Michigan,Mecosta County,26107,2000,40553,37586,40033,520
2010, Michigan,Ottawa County,26139,2010,263801,237638,241040,22761
2000, Michigan,Macomb County,26099,2000,788149,730270,775714,12435
2010, Michigan,Washtenaw County,26161,2010,344791,256880,330931,13860
2000, Michigan,Ottawa County,26139,2000,238314,218105,221622,16692
2020, Michigan,Ottawa County,26139,2020,296200,248796,266818,29382
2020, Michigan,Washtenaw County,26161,2020,372258,257688,351527,20731
2020, Michigan,Mecosta County,26107,2020,39714,35916,38688,1026
2010, Michigan,Livingston County,26093,2010,180967,175015,177507,3460
2020, Michigan,Manistee County,26101,2020,25032,22153,24202,830
2000, Michigan,Manistee County,26101,2000,24527,23095,23888,639
2000, Michigan,Schoolcraft County,26153,2000,8903,7894,8820,83
2020, Michigan,Livingston County,26093,2020,193866,178408,188363,5503
2000, Michigan,Livingston County,26093,2000,156951,152439,154998,1953
2000, Michigan,Van Buren County,26159,2000,76263,67051,70629,5634
2010, Michigan,Charlevoix County,26029,2010,25949,24806,25590,359
2010, Michigan,Mecosta County,26107,2010,42798,40095,42067,731
2000, Michigan,Oscoda County,26135,2000,9418,9213,9329,89
2020, Michigan,Roscommon County,26143,2020,23459,22067,23025,434
2010, Michigan,Genesee County,26049,2010,425790,317393,412807,12983
2020, Michigan,Otsego County,26137,2020,25091,23320,24645,446
2000, Michigan,Berrien County,26021,2000,162453,129459,157565,4888
2020, Michigan,Macomb County,26099,2020,881217,672264,855003,26214
2020, Michigan,Berrien County,26021,2020,154316,113608,145106,9210
2010, Michigan,Marquette County,26103,2010,67077,62911,66310,767
2020, Michigan,Marquette County,26103,2020,66017,59551,64673,1344
2020, Michigan,Genesee County,26049,2020,406211,289255,389952,16259
2010, Michigan,Roscommon County,26143,2010,24449,23791,24174,275
2000, Michigan,Roscommon County,26143,2000,25469,24956,25265,204
2000, Michigan,Gratiot County,26057,2000,42285,38908,40410,1875
2020, Michigan,Gratiot County,26057,2020,41761,36008,38608,3153
2010, Michigan,Gratiot County,26057,2010,42476,38487,40175,2301
2000, Michigan,Charlevoix County,26029,2000,26090,25128,25818,272
2000, Michigan,Washtenaw County,26161,2000,322895,249916,314056,8839
2020, Michigan,Van Buren County,26159,2020,75587,61345,66621,8966
2010, Michigan,Van Buren County,26159,2010,76258,66129,68500,7758
2000, Michigan,Genesee County,26049,2000,436141,328350,425989,10152
2020, Michigan,Oscoda County,26135,2020,8219,7741,8065,154
2000, Michigan,Lenawee County,26091,2000,98890,91484,92006,6884
2000, Michigan,Wayne County,26163,2000,2061162,1065607,1983955,77207
2000, Michigan,Gladwin County,26051,2000,26023,25411,25774,249
2010, Michigan,Gladwin County,26051,2010,25692,25111,25382,310
2000, Michigan,Mason County,26105,2000,28274,27098,27422,852
2000, Michigan,Leelanau County,26089,2000,21119,19751,20425,694
2010, Michigan,Cheboygan County,26031,2010,26152,24459,25941,211
2020, Michigan,Cheboygan County,26031,2020,25579,23016,25238,341
2010, Michigan,Tuscola County,26157,2010,55729,53578,54158,1571
2000, Michigan,Tuscola County,26157,2000,58266,55963,56924,1342
2020, Michigan,Tuscola County,26157,2020,53323,49413,51515,1808
2020, Michigan,Mason County,26105,2020,29052,26456,27762,1290
2010, Michigan,Ontonagon County,26131,2010,6780,6594,6716,64
2000, Michigan,Ontonagon County,26131,2000,7818,7603,7760,58
2000, Michigan,Oakland County,26125,2000,1194156,988194,1165157,28999
2010, Michigan,Mason County,26105,2010,28705,27225,27555,1150
2020, Michigan,Ontonagon County,26131,2020,5816,5473,5748,68
2020, Michigan,Oakland County,26125,2020,1274395,893318,1213557,60838
2010, Michigan,Oakland County,26125,2010,1202362,928912,1160442,41920
2000, Michigan,Luce County,26095,2000,7024,5819,6901,123
2020, Michigan,Luce County,26095,2020,5339,4533,5265,74
2010, Michigan,Gogebic County,26053,2010,16427,15059,16285,142
2020, Michigan,Gogebic County,26053,2020,14380,13052,14158,222
2020, Michigan,Calhoun County,26025,2020,134310,102712,126884,7426
2010, Michigan,Newaygo County,26123,2010,48460,45625,45797,2663
2020, Michigan,Newaygo County,26123,2020,49978,44822,47009,2969
2000, Michigan,Newaygo County,26123,2000,47874,45386,46029,1845
2010, Michigan,Luce County,26095,2010,6631,5331,6549,82
2000, Michigan,Calhoun County,26025,2000,137985,115804,133634,4351
2000, Michigan,Gogebic County,26053,2000,17370,16370,17217,153
2010, Michigan,Calhoun County,26025,2010,136146,111915,129969,6177
2020, Michigan,Gladwin County,26051,2020,25386,24049,24904,482
2000, Michigan,Oceana County,26127,2000,26873,24284,23754,3119
2000, Michigan,Cheboygan County,26031,2000,26448,25072,26246,202
2010, Michigan,Menominee County,26109,2010,24029,22891,23751,278
2020, Michigan,Osceola County,26133,2020,22891,21414,22491,400
2000, Michigan,Grand Traverse County,26055,2000,77654,74945,76499,1155
2020, Michigan,Oceana County,26127,2020,26659,22260,22551,4108
2010, Michigan,Shiawassee County,26155,2010,70648,68315,68953,1695
2000, Michigan,Osceola County,26133,2000,23197,22620,22967,230
2010, Michigan,Osceola County,26133,2010,23528,22791,23184,344
2010, Michigan,Wayne County,26163,2010,1820584,951936,1725324,95260
2010, Michigan,Oceana County,26127,2010,26570,23952,22941,3629
2010, Michigan,Ogemaw County,26129,2010,21699,21076,21390,309
2020, Michigan,Wayne County,26163,2020,1793561,882484,1675912,117649
2000, Michigan,Shiawassee County,26155,2000,71687,69818,70392,1295
2010, Michigan,Cass County,26027,2010,52293,46496,50723,1570
2020, Michigan,Cass County,26027,2020,51589,44005,49428,2161
2000, Michigan,Menominee County,26109,2000,25326,24375,25136,190
2020, Michigan,Leelanau County,26089,2020,22301,20039,21384,917
2010, Michigan,Grand Traverse County,26055,2010,86986,82334,85112,1874
2000, Michigan,Branch County,26023,2000,45787,42751,44422,1365
2020, Michigan,Grand Traverse County,26055,2020,95238,86508,92228,3010
2000, Michigan,Cass County,26027,2000,51104,45582,49871,1233
2020, Michigan,Menominee County,26109,2020,23502,21499,23016,486
2000, Michigan,Ogemaw County,26129,2000,21645,21100,21393,252
2010, Minnesota,Marshall County,27089,2010,9439,9119,9102,337
2010, Minnesota,Traverse County,27155,2010,3558,3352,3508,50
2000, Minnesota,Traverse County,27155,2000,4134,3986,4084,50
2010, Minnesota,Redwood County,27127,2010,16059,14305,15724,335
2010, Minnesota,Lincoln County,27081,2010,5896,5777,5824,72
2000, Minnesota,Roseau County,27135,2000,16338,15671,16267,71
2000, Minnesota,Cass County,27021,2000,27150,23490,26930,220
2020, Minnesota,Redwood County,27127,2020,15425,13250,14929,496
2010, Minnesota,Sherburne County,27141,2010,88499,83211,86558,1941
2020, Minnesota,Rice County,27131,2020,67097,52637,60314,6783
2020, Minnesota,Kittson County,27069,2020,4207,4011,4124,83
2010, Minnesota,Kittson County,27069,2010,4552,4484,4483,69
2020, Minnesota,Traverse County,27155,2020,3360,2870,3163,197
2000, Minnesota,Redwood County,27127,2000,16815,15969,16623,192
2020, Minnesota,Cass County,27021,2020,30066,24801,29640,426
2000, Minnesota,Norman County,27107,2000,7442,7092,7215,227
2020, Minnesota,Sherburne County,27141,2020,97183,85504,94363,2820
2000, Minnesota,Clay County,27027,2000,51229,48149,49357,1872
2010, Minnesota,Roseau County,27135,2010,15629,14767,15513,116
2020, Minnesota,Roseau County,27135,2020,15331,13762,15093,238
2000, Minnesota,Murray County,27101,2000,9165,9013,9030,135
2010, Minnesota,Murray County,27101,2010,8725,8435,8483,242
2020, Minnesota,Murray County,27101,2020,8179,7571,7797,382
2010, Minnesota,Waseca County,27161,2010,19136,17933,18151,985
2010, Minnesota,Norman County,27107,2010,6852,6455,6576,276
2000, Minnesota,Rice County,27131,2000,56665,53032,53548,3117
2010, Minnesota,Cass County,27021,2010,28567,24534,28227,340
2020, Minnesota,Watonwan County,27165,2020,11253,8209,8026,3227
2010, Minnesota,Clay County,27027,2010,58999,54684,56943,2056
2000, Minnesota,Rock County,27133,2000,9721,9456,9597,124
2020, Minnesota,Waseca County,27161,2020,18968,17040,17697,1271
2000, Minnesota,Sherburne County,27141,2000,64417,62308,63708,709
2010, Minnesota,Rice County,27131,2010,64142,57275,59020,5122
2020, Minnesota,Renville County,27129,2020,14723,13158,13404,1319
2020, Minnesota,Norman County,27107,2020,6441,5814,6153,288
2020, Minnesota,Rock County,27133,2020,9704,8997,9340,364
2010, Minnesota,Rock County,27133,2010,9687,9365,9490,197
2000, Minnesota,Renville County,27129,2000,17154,16419,16278,876
2010, Minnesota,Renville County,27129,2010,15730,15014,14684,1046
2020, Minnesota,Clay County,27027,2020,65318,55451,62307,3011
2000, Minnesota,Marshall County,27089,2000,10155,9873,9857,298
2020, Minnesota,Marshall County,27089,2020,9040,8473,8650,390
2000, Minnesota,Kittson County,27069,2000,5285,5184,5218,67
2010, Minnesota,Fillmore County,27045,2010,20866,20497,20659,207
2000, Minnesota,Lac qui Parle County,27073,2000,8067,7974,8046,21
2020, Minnesota,Yellow Medicine County,27173,2020,9528,8524,9080,448
2000, Minnesota,Yellow Medicine County,27173,2000,11080,10647,10885,195
2010, Minnesota,Yellow Medicine County,27173,2010,10438,9806,10041,397
2010, Minnesota,Crow Wing County,27035,2010,62500,60368,61848,652
2000, Minnesota,Crow Wing County,27035,2000,55099,53801,54718,381
2020, Minnesota,Crow Wing County,27035,2020,66123,61586,65211,912
2010, Minnesota,Brown County,27015,2010,25893,25245,25033,860
2020, Minnesota,Brown County,27015,2020,25912,24321,24741,1171
2000, Minnesota,Brown County,27015,2000,26911,26325,26366,545
2010, Minnesota,Morrison County,27097,2010,33198,32426,32796,402
2020, Minnesota,Morrison County,27097,2020,34010,32245,33377,633
2010, Minnesota,Jackson County,27063,2010,10266,9830,9989,277
2020, Minnesota,Jackson County,27063,2020,9989,9133,9588,401
2000, Minnesota,Jackson County,27063,2000,11268,10938,11058,210
2000, Minnesota,Morrison County,27097,2000,31712,31230,31509,203
2000, Minnesota,Steele County,27147,2000,33680,32061,32414,1266
2010, Minnesota,Clearwater County,27029,2010,8695,7579,8575,120
2010, Minnesota,Steele County,27147,2010,36576,34038,34294,2282
2010, Minnesota,Stearns County,27145,2010,150642,138262,146452,4190
2000, Minnesota,Koochiching County,27071,2000,14355,13798,14274,81
2010, Minnesota,Scott County,27139,2010,129928,112212,124157,5771
2000, Minnesota,Scott County,27139,2000,89498,83813,87117,2381
2010, Minnesota,Pennington County,27113,2010,13930,13067,13550,380
2010, Minnesota,Todd County,27153,2010,24895,23727,23607,1288
2000, Minnesota,Todd County,27153,2000,24426,23826,23963,463
2020, Minnesota,Todd County,27153,2020,25262,22415,23054,2208
2020, Minnesota,Goodhue County,27049,2020,47582,42850,45785,1797
2010, Minnesota,Goodhue County,27049,2010,46183,43684,44841,1342
2000, Minnesota,Goodhue County,27049,2000,44127,42613,43654,473
2020, Minnesota,Scott County,27139,2020,150928,117201,141920,9008
2020, Minnesota,Pennington County,27113,2020,13992,12434,13321,671
2000, Minnesota,Pennington County,27113,2000,13584,13179,13415,169
2000, Minnesota,Stearns County,27145,2000,133166,127832,131339,1827
2020, Minnesota,Stearns County,27145,2020,158292,130858,151341,6951
2020, Minnesota,Steele County,27147,2020,37406,32151,34266,3140
2010, Minnesota,Martin County,27091,2010,20840,20142,20096,744
2000, Minnesota,Clearwater County,27029,2000,8423,7518,8358,65
2020, Minnesota,Grant County,27051,2020,6074,5721,5939,135
2000, Minnesota,Dakota County,27037,2000,355904,325166,345445,10459
2010, Minnesota,Dakota County,27037,2010,398552,339499,374586,23966
2010, Minnesota,Wilkin County,27167,2010,6576,6381,6446,130
2000, Minnesota,Wilkin County,27167,2000,7138,6979,7028,110
2000, Minnesota,Mower County,27099,2000,38603,36571,36957,1646
2020, Minnesota,Mower County,27099,2020,40029,30804,34948,5081
2000, Minnesota,Stevens County,27149,2000,10053,9664,9963,90
2010, Minnesota,Stevens County,27149,2010,9726,9110,9389,337
2010, Minnesota,Mower County,27099,2010,39163,35495,35025,4138
2020, Minnesota,Lac qui Parle County,27073,2020,6719,6290,6517,202
2010, Minnesota,Lac qui Parle County,27073,2010,7259,7087,7151,108
2020, Minnesota,Wilkin County,27167,2020,6506,5993,6295,211
2020, Minnesota,Stevens County,27149,2020,9671,8254,8685,986
2020, Minnesota,Martin County,27091,2020,20025,18361,18705,1320
2000, Minnesota,Martin County,27091,2000,21802,21195,21381,421
2020, Minnesota,Dakota County,27037,2020,439882,330482,403577,36305
2020, Minnesota,Clearwater County,27029,2020,8524,7197,8423,101
2020, Minnesota,Isanti County,27059,2020,41135,37888,40239,896
2010, Minnesota,Isanti County,27059,2010,37816,36319,37234,582
2000, Minnesota,Grant County,27051,2000,6289,6181,6256,33
2010, Minnesota,Grant County,27051,2010,6018,5864,5924,94
2000, Minnesota,Anoka County,27003,2000,298084,279133,293123,4961
2020, Minnesota,Anoka County,27003,2020,363887,280171,344381,19506
2010, Minnesota,Anoka County,27003,2010,330844,287802,318824,12020
2010, Minnesota,Lyon County,27083,2010,25857,23360,24316,1541
2000, Minnesota,Lyon County,27083,2000,25425,23792,24416,1009
2010, Minnesota,Washington County,27163,2010,238136,209012,230009,8127
2020, Minnesota,Washington County,27163,2020,267568,211654,254474,13094
2000, Minnesota,Washington County,27163,2000,201130,188317,197238,3892
2000, Minnesota,Itasca County,27061,2000,43992,41632,43729,263
2020, Minnesota,Itasca County,27061,2020,45014,40371,44396,618
2010, Minnesota,Itasca County,27061,2010,45058,42195,44641,417
2020, Minnesota,Lyon County,27083,2020,25269,20946,23525,1744
2020, Minnesota,Lincoln County,27081,2020,5640,5406,5533,107
2000, Minnesota,Isanti County,27059,2000,31287,30551,31028,259
2000, Minnesota,Lincoln County,27081,2000,6429,6353,6374,55
2020, Minnesota,Koochiching County,27071,2020,12062,10975,11895,167
2020, Minnesota,Sibley County,27143,2020,14836,13304,13521,1315
2000, Minnesota,Carver County,27019,2000,70205,67361,68414,1791
2020, Minnesota,Meeker County,27093,2020,23400,21865,22450,950
2000, Minnesota,Meeker County,27093,2000,22644,22043,22157,487
2010, Minnesota,Meeker County,27093,2010,23300,22663,22533,767
2020, Minnesota,Carver County,27019,2020,106922,92448,101614,5308
2000, Minnesota,Benton County,27009,2000,34226,32933,33919,307
2000, Minnesota,Big Stone County,27011,2000,5820,5729,5800,20
2000, Minnesota,Chisago County,27025,2000,41101,39953,40628,473
2020, Minnesota,Big Stone County,27011,2020,5166,4832,5026,140
2010, Minnesota,Big Stone County,27011,2010,5269,5175,5228,41
2010, Minnesota,Chisago County,27025,2010,53887,51621,53052,835
2020, Minnesota,Chisago County,27025,2020,56621,51394,55170,1451
2020, Minnesota,Faribault County,27043,2020,13921,12736,12908,1013
2010, Minnesota,Dodge County,27039,2010,20087,19294,19172,915
2000, Minnesota,Dodge County,27039,2000,17731,17125,17201,530
2020, Minnesota,Dodge County,27039,2020,20867,19088,19810,1057
2010, Minnesota,Sibley County,27143,2010,15226,14430,14128,1098
2020, Minnesota,Ramsey County,27123,2020,552352,328949,507318,45034
2010, Minnesota,Hennepin County,27053,2010,1152425,856834,1074749,77676
2000, Minnesota,Hennepin County,27053,2000,1116200,898921,1070761,45439
2000, Minnesota,Faribault County,27043,2000,16181,15714,15615,566
2020, Minnesota,Winona County,27169,2020,49671,44638,47782,1889
2010, Minnesota,Pope County,27121,2010,10995,10766,10900,95
2020, Minnesota,Wabasha County,27157,2020,21387,20091,20679,708
2020, Minnesota,Wadena County,27159,2020,14065,13128,13792,273
2000, Minnesota,Otter Tail County,27111,2000,57159,55505,56202,957
2000, Minnesota,Ramsey County,27123,2000,511035,395406,484056,26979
2010, Minnesota,Ramsey County,27123,2010,508640,356547,472157,36483
2020, Minnesota,Pipestone County,27117,2020,9424,8159,8620,804
2000, Minnesota,Sibley County,27143,2000,15356,14676,14522,834
2000, Minnesota,Waseca County,27161,2000,19526,18482,18960,566
2000, Minnesota,Wadena County,27159,2000,13713,13424,13585,128
2000, Minnesota,Wabasha County,27157,2000,21610,21171,21246,364
2010, Minnesota,Benton County,27009,2010,38451,36348,37819,632
2010, Minnesota,Faribault County,27043,2010,14553,14042,13736,817
2010, Minnesota,St. Louis County,27137,2010,200226,186212,197817,2409
2000, Minnesota,Le Sueur County,27079,2000,25426,24551,24429,997
2000, Minnesota,Cook County,27031,2000,5168,4623,5129,39
2000, Minnesota,Cottonwood County,27033,2000,12167,11587,11900,267
2010, Minnesota,Cook County,27031,2010,5176,4559,5118,58
2020, Minnesota,Cook County,27031,2020,5600,4686,5477,123
2000, Minnesota,St. Louis County,27137,2000,200528,190211,198931,1597
2020, Minnesota,Kandiyohi County,27067,2020,43732,35004,37816,5916
2000, Minnesota,Kandiyohi County,27067,2000,41203,38576,37908,3295
2000, Minnesota,Red Lake County,27125,2000,4299,4189,4286,13
2020, Minnesota,Pine County,27115,2020,28876,25480,28163,713
2020, Minnesota,Polk County,27119,2020,31192,27229,29193,1999
2010, Minnesota,Cottonwood County,27033,2010,11687,10773,10967,720
2010, Minnesota,Polk County,27119,2010,31600,29495,29880,1720
2010, Minnesota,Kandiyohi County,27067,2010,42239,39206,37529,4710
2020, Minnesota,Otter Tail County,27111,2020,60081,54910,57865,2216
2010, Minnesota,Kanabec County,27065,2010,16239,15754,16025,214
2000, Minnesota,Polk County,27119,2000,31369,29543,29867,1502
2010, Minnesota,Wabasha County,27157,2010,21676,21000,21084,592
2020, Minnesota,Benton County,27009,2020,41379,36145,40163,1216
2020, Minnesota,Swift County,27151,2020,9838,8807,9176,662
2010, Minnesota,Carver County,27019,2010,91042,84450,87527,3515
2020, Minnesota,St. Louis County,27137,2020,200231,177385,196628,3603
2010, Minnesota,Wright County,27171,2010,124700,118518,121648,3052
2020, Minnesota,Kanabec County,27065,2020,16032,15088,15794,238
2000, Minnesota,Wright County,27171,2000,89986,88055,88992,994
2010, Minnesota,Wadena County,27159,2010,13843,13380,13667,176
2000, Minnesota,Olmsted County,27109,2000,124277,112255,121318,2959
2010, Minnesota,Red Lake County,27125,2010,4089,3934,3988,101
2020, Minnesota,Chippewa County,27023,2020,12598,10653,11355,1243
2000, Minnesota,Chippewa County,27023,2000,13088,12666,12837,251
2000, Minnesota,Kanabec County,27065,2000,14996,14587,14856,140
2010, Minnesota,Pine County,27115,2010,29750,27347,29027,723
2020, Minnesota,Cottonwood County,27033,2020,11517,9617,10402,1115
2000, Minnesota,Pope County,27121,2000,11236,11107,11179,57
2010, Minnesota,Winona County,27169,2010,51461,48573,50217,1244
2010, Minnesota,Olmsted County,27109,2010,144248,123605,138167,6081
2020, Minnesota,Freeborn County,27047,2020,30895,25988,27712,3183
2000, Minnesota,Lake County,27075,2000,11058,10836,10995,63
2010, Minnesota,Lake County,27075,2010,10866,10616,10786,80
2010, Minnesota,Mahnomen County,27087,2010,5413,2713,5314,99
2000, Minnesota,Hubbard County,27057,2000,18376,17698,18252,124
2010, Minnesota,Chippewa County,27023,2010,12441,11632,11830,611
2010, Minnesota,Hubbard County,27057,2010,20428,19314,20101,327
2020, Minnesota,Wright County,27171,2020,141337,127090,136640,4697
2020, Minnesota,Hubbard County,27057,2020,21344,19265,20855,489
2000, Minnesota,Douglas County,27041,2000,32821,32326,32628,193
2000, Minnesota,Carlton County,27017,2000,31671,29057,31405,266
2020, Minnesota,Douglas County,27041,2020,39006,36887,38191,815
2010, Minnesota,Le Sueur County,27079,2010,27703,26443,26259,1444
2000, Minnesota,Pipestone County,27117,2000,9895,9566,9826,69
2020, Minnesota,Pope County,27121,2020,11308,10802,11117,191
2010, Minnesota,Pipestone County,27117,2010,9596,8975,9241,355
2020, Minnesota,Olmsted County,27109,2020,162847,126764,153651,9196
2020, Minnesota,Fillmore County,27045,2020,21228,20278,20887,341
2000, Minnesota,Fillmore County,27045,2000,21122,20894,21009,113
2020, Minnesota,Red Lake County,27125,2020,3935,3647,3832,103
2010, Minnesota,Aitkin County,27001,2010,16202,15494,16051,151
2000, Minnesota,Aitkin County,27001,2000,15301,14752,15209,92
2020, Minnesota,Aitkin County,27001,2020,15697,14538,15477,220
2010, Minnesota,Freeborn County,27047,2010,31255,29121,28505,2750
2010, Minnesota,Koochiching County,27071,2010,13311,12593,13164,147
2000, Minnesota,McLeod County,27085,2000,34898,33717,33630,1268
2010, Minnesota,McLeod County,27085,2010,36651,35159,34840,1811
2000, Minnesota,Freeborn County,27047,2000,32584,31028,30535,2049
2010, Minnesota,Swift County,27151,2010,9783,9453,9433,350
2000, Minnesota,Swift County,27151,2000,11956,10840,11636,320
2020, Minnesota,Lake County,27075,2020,10905,10326,10792,113
2020, Minnesota,McLeod County,27085,2020,36771,33216,34216,2555
2010, Minnesota,Douglas County,27041,2010,36009,35186,35668,341
2020, Minnesota,Le Sueur County,27079,2020,28674,25991,26802,1872
2000, Minnesota,Becker County,27005,2000,30000,26806,29770,230
2000, Minnesota,Winona County,27169,2000,49985,47887,49299,686
2000, Minnesota,Blue Earth County,27013,2000,55941,53121,54953,988
2010, Minnesota,Houston County,27055,2010,19027,18570,18895,132
2020, Minnesota,Hennepin County,27053,2020,1281565,855122,1183315,98250
2000, Minnesota,Houston County,27055,2000,19718,19416,19597,121
2020, Minnesota,Houston County,27055,2020,18843,17900,18600,243
2020, Minnesota,Blue Earth County,27013,2020,69112,58205,65891,3221
2010, Minnesota,Blue Earth County,27013,2010,64013,59400,62427,1586
2010, Minnesota,Otter Tail County,27111,2010,57303,55080,55813,1490
2020, Minnesota,Carlton County,27017,2020,36207,31151,35595,612
2010, Minnesota,Beltrami County,27007,2010,44442,33359,43766,676
2020, Minnesota,Mahnomen County,27087,2020,5411,2303,5257,154
2000, Minnesota,Mahnomen County,27087,2000,5190,3262,5144,46
2010, Minnesota,Mille Lacs County,27095,2010,26097,23778,25720,377
2010, Minnesota,Nicollet County,27103,2010,32727,30666,31501,1226
2020, Minnesota,Mille Lacs County,27095,2020,26459,23281,25978,481
2000, Minnesota,Watonwan County,27165,2000,11876,10515,10072,1804
2010, Minnesota,Becker County,27005,2010,32504,28720,32106,398
2020, Minnesota,Becker County,27005,2020,35183,29818,34608,575
2010, Minnesota,Carlton County,27017,2010,35386,31727,34902,484
2000, Minnesota,Beltrami County,27007,2000,39650,30394,39256,394
2010, Minnesota,Nobles County,27105,2010,21378,16206,16558,4820
2020, Minnesota,Lake of the Woods County,27077,2020,3763,3512,3707,56
2010, Minnesota,Lake of the Woods County,27077,2010,4045,3874,4010,35
2000, Minnesota,Lake of the Woods County,27077,2000,4522,4396,4493,29
2000, Minnesota,Pine County,27115,2000,26530,25047,26065,465
2020, Minnesota,Nobles County,27105,2020,22290,13109,15019,7271
2000, Minnesota,Nobles County,27105,2000,20832,18019,18507,2325
2020, Minnesota,Nicollet County,27103,2020,34454,29744,32654,1800
2000, Minnesota,Nicollet County,27103,2000,29771,28691,29236,535
2000, Minnesota,Mille Lacs County,27095,2000,22330,20890,22116,214
2010, Minnesota,Watonwan County,27165,2010,11211,9740,8873,2338
2020, Minnesota,Beltrami County,27007,2020,46228,32794,45120,1108
2010, Mississippi,Pearl River County,28109,2010,55834,46924,54198,1636
2000, Mississippi,Forrest County,28035,2000,72604,46717,71692,912
2020, Mississippi,Union County,28145,2020,27777,21752,26476,1301
2020, Mississippi,Warren County,28149,2020,44722,21126,43846,876
2000, Mississippi,Sharkey County,28125,2000,6580,1932,6494,86
2010, Mississippi,Marion County,28091,2010,27088,17822,26752,336
2000, Mississippi,Marion County,28091,2000,25595,17138,25437,158
2020, Mississippi,Copiah County,28029,2020,28368,12305,27257,1111
2000, Mississippi,Scott County,28123,2000,28423,16258,26763,1660
2010, Mississippi,Copiah County,28029,2010,29449,13627,28676,773
2020, Mississippi,Marion County,28091,2020,24441,15820,24035,406
2020, Mississippi,Carroll County,28015,2020,9998,6543,9844,154
2010, Mississippi,Carroll County,28015,2010,10597,6956,10491,106
2000, Mississippi,Carroll County,28015,2000,10769,6749,10690,79
2000, Mississippi,Copiah County,28029,2000,28757,13747,28425,332
2010, Mississippi,Webster County,28155,2010,10253,8065,10149,104
2010, Mississippi,Coahoma County,28027,2010,26151,5989,25858,293
2020, Mississippi,Coahoma County,28027,2020,21390,4312,21040,350
2000, Mississippi,Coahoma County,28027,2000,30622,8965,30346,276
2010, Mississippi,Union County,28145,2010,27134,21973,25924,1210
2000, Mississippi,Kemper County,28069,2000,10453,4080,10377,76
2020, Mississippi,Kemper County,28069,2020,8988,2820,8921,67
2010, Mississippi,Kemper County,28069,2010,10456,3689,10404,52
2010, Mississippi,Forrest County,28035,2010,74934,44726,72297,2637
2020, Mississippi,Forrest County,28035,2020,78158,43597,74900,3258
2020, Mississippi,Sharkey County,28125,2020,3800,970,3739,61
2010, Mississippi,Sharkey County,28125,2010,4916,1370,4877,39
2000, Mississippi,Webster County,28155,2000,10294,7983,10120,174
2010, Mississippi,Oktibbeha County,28105,2010,47671,28224,46988,683
2020, Mississippi,Pearl River County,28109,2020,56145,44833,53861,2284
2000, Mississippi,Panola County,28107,2000,34274,17302,33890,384
2010, Mississippi,Panola County,28107,2010,34707,17161,34213,494
2020, Mississippi,Panola County,28107,2020,33208,15765,32530,678
2020, Mississippi,Jefferson Davis County,28065,2020,11321,4357,11220,101
2000, Mississippi,Jefferson Davis County,28065,2000,13962,5816,13855,107
2010, Mississippi,Jefferson Davis County,28065,2010,12487,4834,12386,101
2020, Mississippi,Quitman County,28119,2020,6176,1490,6155,21
2010, Mississippi,Tunica County,28143,2010,10778,2553,10533,245
2000, Mississippi,Tunica County,28143,2000,9227,2541,8994,233
2010, Mississippi,Quitman County,28119,2010,8223,2381,8168,55
2000, Mississippi,Quitman County,28119,2000,10117,3083,10062,55
2020, Mississippi,Tunica County,28143,2020,9782,1869,9591,191
2010, Mississippi,Madison County,28089,2010,95203,54270,92397,2806
2000, Mississippi,Alcorn County,28003,2000,34558,30193,34115,443
2010, Mississippi,Alcorn County,28003,2010,37057,31656,36047,1010
2000, Mississippi,Madison County,28089,2000,74674,45021,73932,742
2020, Mississippi,Madison County,28089,2020,109145,60827,105028,4117
2020, Mississippi,Monroe County,28095,2020,34180,22629,33707,473
2000, Mississippi,Monroe County,28095,2000,38014,25991,37753,261
2020, Mississippi,Alcorn County,28003,2020,34740,27992,33492,1248
2010, Mississippi,Monroe County,28095,2010,36989,25035,36634,355
2010, Mississippi,Marshall County,28093,2010,37144,18614,35952,1192
2000, Mississippi,Marshall County,28093,2000,34993,16925,34568,425
2020, Mississippi,Marshall County,28093,2020,33752,16500,32212,1540
2010, Mississippi,Calhoun County,28013,2010,14962,10096,14157,805
2000, Mississippi,Calhoun County,28013,2000,15069,10460,14751,318
2010, Mississippi,Warren County,28149,2010,48773,24548,47877,896
2020, Mississippi,Jones County,28067,2020,67246,42076,63107,4139
2010, Mississippi,Jones County,28067,2010,67761,45531,64562,3199
2000, Mississippi,Jones County,28067,2000,64958,46192,63687,1271
2020, Mississippi,Covington County,28031,2020,18340,11118,17922,418
2020, Mississippi,Webster County,28155,2020,9926,7726,9771,155
2020, Mississippi,Montgomery County,28097,2020,9822,5114,9716,106
2000, Mississippi,Pearl River County,28109,2000,48621,41596,47935,686
2000, Mississippi,Wayne County,28153,2000,21216,13004,21082,134
2020, Mississippi,Scott County,28123,2020,27990,13451,23842,4148
2010, Mississippi,Montgomery County,28097,2010,10925,5790,10828,97
2010, Mississippi,George County,28039,2010,22578,20266,22125,453
2010, Mississippi,Jefferson County,28063,2010,7726,1060,7698,28
2020, Mississippi,Jefferson County,28063,2020,7260,894,7186,74
2000, Mississippi,Jefferson County,28063,2000,9740,1272,9676,64
2020, Mississippi,George County,28039,2020,24350,21112,23678,672
2000, Mississippi,George County,28039,2000,19144,17110,18837,307
2000, Mississippi,Adams County,28001,2000,34340,15809,34067,273
2000, Mississippi,Union County,28145,2000,25362,21156,24949,413
2010, Mississippi,Scott County,28123,2010,28264,15051,25251,3013
2020, Mississippi,Adams County,28001,2020,29538,10994,28526,1012
2000, Mississippi,Oktibbeha County,28105,2000,42902,25167,42441,461
2000, Mississippi,Warren County,28149,2000,49644,27288,49130,514
2020, Mississippi,Oktibbeha County,28105,2020,51788,29606,50520,1268
2000, Mississippi,Rankin County,28121,2000,115327,93450,113807,1520
2010, Mississippi,Rankin County,28121,2010,141617,109523,137822,3795
2020, Mississippi,Rankin County,28121,2020,157031,112872,151964,5067
2000, Mississippi,Franklin County,28037,2000,8448,5305,8403,45
2010, Mississippi,Franklin County,28037,2010,8118,5257,8071,47
2020, Mississippi,Franklin County,28037,2020,7675,4921,7615,60
2000, Mississippi,Montgomery County,28097,2000,12189,6613,12086,103
2000, Mississippi,Covington County,28031,2000,19407,12307,19252,155
2010, Mississippi,Covington County,28031,2010,19568,12319,19199,369
2010, Mississippi,Adams County,28001,2010,32297,13793,30147,2150
2020, Mississippi,Calhoun County,28013,2020,13266,8776,12519,747
2010, Mississippi,Walthall County,28147,2010,15443,8250,15205,238
2020, Mississippi,Amite County,28005,2020,12720,7463,12591,129
2010, Mississippi,Lauderdale County,28075,2010,80261,43957,78813,1448
2020, Mississippi,Lauderdale County,28075,2020,72984,36919,71195,1789
2000, Mississippi,Lauderdale County,28075,2000,78161,47013,77273,888
2020, Mississippi,Lincoln County,28085,2020,34907,23091,34501,406
2010, Mississippi,DeSoto County,28033,2010,161252,116440,153166,8086
2010, Mississippi,Lincoln County,28085,2010,34869,23864,34539,330
2000, Mississippi,Lincoln County,28085,2000,33166,23010,32937,229
2020, Mississippi,Grenada County,28043,2020,21629,11339,21319,310
2020, Mississippi,Leflore County,28083,2020,28339,6022,27499,840
2000, Mississippi,Stone County,28131,2000,13622,10818,13452,170
2020, Mississippi,Stone County,28131,2020,18333,13933,17889,444
2010, Mississippi,Grenada County,28043,2010,21906,12465,21709,197
2000, Mississippi,Grenada County,28043,2000,23263,13474,23118,145
2020, Mississippi,Humphreys County,28053,2020,7785,1438,7694,91
2010, Mississippi,Humphreys County,28053,2010,9375,2203,9173,202
2000, Mississippi,Humphreys County,28053,2000,11206,3045,11038,168
2010, Mississippi,Attala County,28007,2010,19564,11000,19241,323
2020, Mississippi,Attala County,28007,2020,17889,9440,17558,331
2010, Mississippi,Stone County,28131,2010,17786,13982,17547,239
2010, Mississippi,Leflore County,28083,2010,32317,8038,31574,743
2000, Mississippi,Leflore County,28083,2000,37947,11384,37227,720
2000, Mississippi,Benton County,28009,2000,8026,4954,7942,84
2010, Mississippi,Yalobusha County,28161,2010,12678,7667,12527,151
2020, Mississippi,Yalobusha County,28161,2020,12481,7381,12318,163
2020, Mississippi,Simpson County,28127,2020,25949,15986,25563,386
2020, Mississippi,Prentiss County,28117,2020,25008,20303,24603,405
2020, Mississippi,Claiborne County,28021,2020,9135,974,9063,72
2000, Mississippi,Lawrence County,28077,2000,13258,8875,13169,89
2010, Mississippi,Prentiss County,28117,2010,25276,21312,24969,307
2000, Mississippi,Yalobusha County,28161,2000,13051,7891,12924,127
2020, Mississippi,Clay County,28025,2020,18636,7212,18450,186
2000, Mississippi,Clay County,28025,2000,21979,9411,21789,190
2010, Mississippi,Clay County,28025,2010,20634,8350,20435,199
2010, Mississippi,Lawrence County,28077,2010,12929,8624,12655,274
2000, Mississippi,Prentiss County,28117,2000,25556,21940,25380,176
2010, Mississippi,Lafayette County,28071,2010,47351,33976,46278,1073
2000, Mississippi,Lafayette County,28071,2000,38744,27838,38317,427
2020, Mississippi,Lafayette County,28071,2020,55813,39274,53671,2142
2000, Mississippi,Harrison County,28047,2000,189601,138692,184691,4910
2020, Mississippi,Harrison County,28047,2020,208621,128098,194645,13976
2010, Mississippi,Harrison County,28047,2010,187105,130366,177168,9937
2010, Mississippi,Tallahatchie County,28135,2010,15378,5988,14512,866
2020, Mississippi,Hinds County,28049,2020,227742,58644,223178,4564
2010, Mississippi,Hinds County,28049,2010,245285,69769,241655,3630
2000, Mississippi,Attala County,28007,2000,19661,11470,19381,280
2010, Mississippi,Lamar County,28073,2010,55658,43011,54453,1205
2000, Mississippi,Lamar County,28073,2000,39070,33342,38644,426
2020, Mississippi,Smith County,28129,2020,14209,10613,14011,198
2000, Mississippi,Smith County,28129,2000,16182,12316,16086,96
2010, Mississippi,Holmes County,28051,2010,19198,3001,19064,134
2000, Mississippi,Tate County,28137,2000,25370,17211,25147,223
2000, Mississippi,Hancock County,28045,2000,42967,38752,42192,775
2020, Mississippi,Newton County,28101,2020,21291,12857,20962,329
2010, Mississippi,Smith County,28129,2010,16491,12503,16293,198
2020, Mississippi,Hancock County,28045,2020,46053,37847,44135,1918
2000, Mississippi,Newton County,28101,2000,21838,14197,21640,198
2010, Mississippi,Newton County,28101,2010,21720,13734,21433,287
2020, Mississippi,Pontotoc County,28115,2020,31184,24126,29136,2048
2020, Mississippi,Winston County,28159,2020,17714,8894,17488,226
2010, Mississippi,Tate County,28137,2010,28886,19313,28247,639
2010, Mississippi,Winston County,28159,2010,19198,9972,19014,184
2010, Mississippi,Hancock County,28045,2010,43929,38842,42483,1446
2000, Mississippi,Pontotoc County,28115,2000,26726,22557,26245,481
2010, Mississippi,Pontotoc County,28115,2010,29957,23984,28108,1849
2020, Mississippi,Lamar County,28073,2020,64222,44456,61860,2362
2000, Mississippi,Simpson County,28127,2000,27639,17796,27321,318
2000, Mississippi,Holmes County,28051,2000,21609,4424,21415,194
2020, Mississippi,Tate County,28137,2020,28064,18168,27259,805
2000, Mississippi,Hinds County,28049,2000,250800,93584,248822,1978
2000, Mississippi,Tallahatchie County,28135,2000,14903,5904,14766,137
2010, Mississippi,Amite County,28005,2010,13131,7574,13021,110
2020, Mississippi,DeSoto County,28033,2020,185314,110064,175153,10161
2000, Mississippi,DeSoto County,28033,2000,107199,91950,104683,2516
2000, Mississippi,Pike County,28113,2000,38940,19955,38656,284
2020, Mississippi,Pike County,28113,2020,40324,16889,39697,627
2020, Mississippi,Tallahatchie County,28135,2020,12715,5029,12290,425
2010, Mississippi,Pike County,28113,2010,40404,18745,39915,489
2000, Mississippi,Chickasaw County,28017,2000,19440,11060,18995,445
2000, Mississippi,Clarke County,28023,2000,17955,11580,17835,120
2020, Mississippi,Clarke County,28023,2020,15615,9988,15483,132
2010, Mississippi,Clarke County,28023,2010,16732,10741,16600,132
2020, Mississippi,Bolivar County,28011,2020,30985,10111,30191,794
2000, Mississippi,Bolivar County,28011,2000,40633,13507,40156,477
2010, Mississippi,Bolivar County,28011,2010,34145,11446,33506,639
2010, Mississippi,Chickasaw County,28017,2010,17392,9386,16749,643
2020, Mississippi,Chickasaw County,28017,2020,17106,8664,16464,642
2000, Mississippi,Winston County,28159,2000,20160,11141,19917,243
2020, Mississippi,Holmes County,28051,2020,17000,2378,16888,112
2000, Mississippi,Greene County,28041,2000,13299,9681,13193,106
2000, Mississippi,Claiborne County,28021,2000,11831,1796,11737,94
2010, Mississippi,Greene County,28041,2010,14400,10441,14267,133
2020, Mississippi,Jackson County,28059,2020,143252,94709,133202,10050
2010, Mississippi,Tishomingo County,28141,2010,19593,18509,19040,553
2020, Mississippi,Tishomingo County,28141,2020,18850,17349,18313,537
2000, Mississippi,Tishomingo County,28141,2000,19163,18192,18820,343
2020, Mississippi,Yazoo County,28163,2020,26743,10009,25667,1076
2000, Mississippi,Leake County,28079,2000,20940,11755,20500,440
2010, Mississippi,Leake County,28079,2010,23805,11793,22785,1020
2000, Mississippi,Walthall County,28147,2000,15156,8277,14955,201
2020, Mississippi,Greene County,28041,2020,13530,9848,13359,171
2000, Mississippi,Tippah County,28139,2000,20826,17046,20392,434
2010, Mississippi,Tippah County,28139,2010,22232,17779,21247,985
2020, Mississippi,Sunflower County,28133,2020,25971,6894,25310,661
2020, Mississippi,Washington County,28151,2020,44922,11264,44338,584
2010, Mississippi,Choctaw County,28019,2010,8547,5846,8471,76
2000, Mississippi,Choctaw County,28019,2000,9758,6638,9679,79
2010, Mississippi,Jackson County,28059,2010,139668,100735,133290,6378
2000, Mississippi,Jackson County,28059,2000,131420,99026,128613,2807
2010, Mississippi,Wayne County,28153,2010,20747,12300,20501,246
2020, Mississippi,Wayne County,28153,2020,19779,11352,19436,343
2000, Mississippi,Jasper County,28061,2000,18149,8433,18032,117
2000, Mississippi,Sunflower County,28133,2000,34369,9927,33921,448
2010, Mississippi,Jasper County,28061,2010,17062,7894,16926,136
2020, Mississippi,Jasper County,28061,2020,16367,7561,16198,169
2000, Mississippi,Amite County,28005,2000,13599,7673,13486,113
2010, Mississippi,Lowndes County,28087,2010,59779,32259,58865,914
2000, Mississippi,Lowndes County,28087,2000,61586,34775,60902,684
2020, Mississippi,Itawamba County,28057,2020,23863,21217,23479,384
2020, Mississippi,Lowndes County,28087,2020,58879,29775,57556,1323
2010, Mississippi,Noxubee County,28103,2010,11545,3133,11453,92
2020, Mississippi,Noxubee County,28103,2020,10285,2661,10113,172
2010, Mississippi,Sunflower County,28133,2010,29450,7493,29046,404
2020, Mississippi,Choctaw County,28019,2020,8246,5593,8129,117
2000, Mississippi,Yazoo County,28163,2000,28149,12593,26916,1233
2010, Mississippi,Yazoo County,28163,2010,28065,11212,26764,1301
2020, Mississippi,Leake County,28079,2020,21275,10145,20045,1230
2000, Mississippi,Noxubee County,28103,2000,12548,3700,12407,141
2010, Mississippi,Itawamba County,28057,2010,23401,21623,23101,300
2020, Mississippi,Tippah County,28139,2020,21815,16806,20697,1118
2000, Mississippi,Neshoba County,28099,2000,28684,18788,28352,332
2010, Mississippi,Wilkinson County,28157,2010,9878,2834,9837,41
2020, Mississippi,Lee County,28081,2020,83343,53394,80515,2828
2010, Mississippi,Benton County,28009,2010,8729,5284,8581,148
2020, Mississippi,Benton County,28009,2020,7646,4582,7501,145
2000, Mississippi,Itawamba County,28057,2000,22770,21055,22544,226
2010, Mississippi,Lee County,28081,2010,82910,57497,80919,1991
2000, Mississippi,Lee County,28081,2000,75755,55800,74873,882
2020, Mississippi,Neshoba County,28099,2020,29087,16523,28653,434
2010, Mississippi,Claiborne County,28021,2010,9604,1367,9530,74
2020, Mississippi,Wilkinson County,28157,2020,8587,2531,8517,70
2000, Mississippi,Perry County,28111,2000,12138,9245,12016,122
2000, Mississippi,Wilkinson County,28157,2000,10312,3219,10267,45
2010, Mississippi,Perry County,28111,2010,12250,9575,12131,119
2020, Mississippi,Perry County,28111,2020,11511,8942,11357,154
2010, Mississippi,Neshoba County,28099,2010,29676,17974,29207,469
2010, Mississippi,Washington County,28151,2010,51137,13784,50608,529
2010, Mississippi,Issaquena County,28055,2010,1406,486,1398,8
2000, Mississippi,Issaquena County,28055,2000,2274,826,2264,10
2000, Mississippi,Washington County,28151,2000,62977,21393,62446,531
2020, Mississippi,Issaquena County,28055,2020,1338,530,1210,128
2020, Mississippi,Walthall County,28147,2020,13884,7593,13681,203
2020, Mississippi,Lawrence County,28077,2020,12016,7847,11809,207
2010, Mississippi,Simpson County,28127,2010,27503,17260,27116,387
2010, Missouri,Marion County,29127,2010,28781,26421,28390,391
2020, Missouri,Maries County,29125,2020,8432,7841,8298,134
2000, Missouri,New Madrid County,29143,2000,19760,16442,19577,183
2000, Missouri,Platte County,29165,2000,73781,67473,71570,2211
2010, Missouri,Platte County,29165,2010,89322,77914,84898,4424
2010, Missouri,Maries County,29125,2010,9176,8964,9101,75
2010, Missouri,New Madrid County,29143,2010,18956,15491,18742,214
2000, Missouri,Lawrence County,29109,2000,35204,33682,34009,1195
2020, Missouri,Lawrence County,29109,2020,38001,33137,35014,2987
2010, Missouri,Lawrence County,29109,2010,38634,36179,36190,2444
2020, Missouri,St. Clair County,29185,2020,9284,8643,9106,178
2020, Missouri,Marion County,29127,2020,28525,25119,28009,516
2000, Missouri,St. Clair County,29185,2000,9652,9397,9557,95
2010, Missouri,St. Clair County,29185,2010,9805,9464,9635,170
2020, Missouri,Platte County,29165,2020,106718,83516,99557,7161
2020, Missouri,St. Francois County,29187,2020,66922,59940,65833,1089
2000, Missouri,Mercer County,29129,2000,3757,3709,3746,11
2000, Missouri,Ripley County,29181,2000,13509,13127,13377,132
2020, Missouri,Mercer County,29129,2020,3538,3303,3383,155
2000, Missouri,Saline County,29195,2000,23756,21387,22706,1050
2020, Missouri,Pike County,29163,2020,17587,15546,17153,434
2010, Missouri,Pike County,29163,2010,18516,16698,18185,331
2010, Missouri,Saline County,29195,2010,23370,20135,21445,1925
2010, Missouri,St. Francois County,29187,2010,65359,61180,64581,778
2000, Missouri,St. Francois County,29187,2000,55641,53494,55194,447
2020, Missouri,Ripley County,29181,2020,10679,9942,10552,127
2000, Missouri,Pike County,29163,2000,18351,16230,18056,295
2000, Missouri,Polk County,29167,2000,26992,26253,26642,350
2010, Missouri,Ripley County,29181,2010,14100,13649,13958,142
2020, Missouri,Polk County,29167,2020,31519,29053,30728,791
2020, Missouri,Saline County,29195,2020,23333,17995,20503,2830
2010, Missouri,Mercer County,29129,2010,3785,3700,3757,28
2000, Missouri,Marion County,29127,2000,28289,26382,28037,252
2000, Missouri,Osage County,29151,2000,13062,12884,12985,77
2010, Missouri,Osage County,29151,2010,13878,13718,13794,84
2020, Missouri,Osage County,29151,2020,13274,12745,13149,125
2020, Missouri,Oregon County,29149,2020,8635,8049,8518,117
2000, Missouri,Oregon County,29149,2000,10344,9786,10231,113
2010, Missouri,Oregon County,29149,2010,10881,10511,10750,131
2020, Missouri,Ray County,29177,2020,23158,21109,22578,580
2010, Missouri,Polk County,29167,2010,31137,29946,30522,615
2000, Missouri,Maries County,29125,2000,8903,8674,8800,103
2010, Missouri,Miller County,29131,2010,24748,23941,24405,343
2000, Missouri,Randolph County,29175,2000,24663,22339,24381,282
2000, Missouri,Scott County,29201,2000,40422,35442,39974,448
2020, Missouri,Scott County,29201,2020,38059,30913,37124,935
2010, Missouri,Scott County,29201,2010,39191,33606,38486,705
2010, Missouri,Shelby County,29205,2010,6373,6249,6302,71
2010, Missouri,Livingston County,29117,2010,15195,14494,15014,181
2020, Missouri,Livingston County,29117,2020,14557,13473,14318,239
2000, Missouri,Laclede County,29105,2000,32513,31552,32112,401
2010, Missouri,Laclede County,29105,2010,35571,34051,34852,719
2000, Missouri,Livingston County,29117,2000,14558,13962,14464,94
2020, Missouri,Laclede County,29105,2020,36039,32848,35084,955
2000, Missouri,Macon County,29121,2000,15762,15160,15641,121
2020, Missouri,Macon County,29121,2020,15209,13855,14933,276
2010, Missouri,Macon County,29121,2010,15566,14816,15416,150
2010, Missouri,Shannon County,29203,2010,8441,8103,8302,139
2020, Missouri,Shannon County,29203,2020,7031,6506,6890,141
2010, Missouri,Scotland County,29199,2010,4843,4776,4810,33
2020, Missouri,Scotland County,29199,2020,4716,4550,4681,35
2010, Missouri,McDonald County,29119,2010,23083,19619,20496,2587
2020, Missouri,McDonald County,29119,2020,23303,17093,20485,2818
2000, Missouri,McDonald County,29119,2000,21681,19440,19651,2030
2010, Missouri,Perry County,29157,2010,18971,18442,18653,318
2000, Missouri,Mississippi County,29133,2000,13427,10463,13298,129
2010, Missouri,Knox County,29103,2010,4131,4047,4097,34
2020, Missouri,Knox County,29103,2020,3744,3573,3721,23
2000, Missouri,Knox County,29103,2000,4361,4296,4335,26
2000, Missouri,Morgan County,29141,2000,19309,18796,19148,161
2020, Missouri,Morgan County,29141,2020,21006,19497,20560,446
2020, Missouri,Moniteau County,29135,2020,15473,13876,14609,864
2010, Missouri,Reynolds County,29179,2010,6696,6477,6632,64
2000, Missouri,Reynolds County,29179,2000,6689,6398,6634,55
2010, Missouri,Moniteau County,29135,2010,15607,14426,15021,586
2020, Missouri,Reynolds County,29179,2020,6096,5690,5997,99
2010, Missouri,Morgan County,29141,2010,20565,19770,20200,365
2010, Missouri,Pemiscot County,29155,2010,18296,12882,17955,341
2020, Missouri,Pemiscot County,29155,2020,15661,10280,15246,415
2020, Missouri,Perry County,29157,2020,18956,17748,18573,383
2000, Missouri,Pemiscot County,29155,2000,20047,14386,19732,315
2000, Missouri,Pulaski County,29169,2000,41165,32254,38761,2404
2000, Missouri,Putnam County,29171,2000,5223,5178,5191,32
2010, Missouri,Putnam County,29171,2010,4979,4889,4943,36
2020, Missouri,Putnam County,29171,2020,4681,4475,4569,112
2000, Missouri,Moniteau County,29135,2000,14827,13752,14392,435
2020, Missouri,Pulaski County,29169,2020,53955,38553,47876,6079
2000, Missouri,Shelby County,29205,2000,6799,6654,6756,43
2020, Missouri,Shelby County,29205,2020,6103,5791,5986,117
2010, Missouri,Mississippi County,29133,2010,14358,10633,14127,231
2020, Missouri,Mississippi County,29133,2020,12577,8910,12354,223
2010, Missouri,Pulaski County,29169,2010,52274,40506,47569,4705
2000, Missouri,Ozark County,29153,2000,9542,9310,9452,90
2020, Missouri,Ozark County,29153,2020,8553,8035,8444,109
2010, Missouri,Ozark County,29153,2010,9723,9468,9595,128
2020, Missouri,Phelps County,29161,2020,44638,38383,43379,1259
2000, Missouri,Phelps County,29161,2000,39825,37132,39340,485
2010, Missouri,Phelps County,29161,2010,45156,41409,44233,923
2010, Missouri,Schuyler County,29197,2010,4431,4369,4402,29
2000, Missouri,Schuyler County,29197,2000,4170,4105,4143,27
2000, Missouri,Miller County,29131,2000,23564,23090,23333,231
2020, Missouri,Schuyler County,29197,2020,4032,3878,3985,47
2000, Missouri,Newton County,29145,2000,52636,49086,51489,1147
2020, Missouri,St. Charles County,29183,2020,405262,339665,389251,16011
2000, Missouri,St. Charles County,29183,2000,283883,268756,279707,4176
2020, Missouri,Miller County,29131,2020,24722,23089,24256,466
2020, Missouri,Ralls County,29173,2020,10355,9748,10259,96
2010, Missouri,Newton County,29145,2010,58114,51914,55577,2537
2020, Missouri,Montgomery County,29139,2020,11322,10518,11093,229
2000, Missouri,Montgomery County,29139,2000,12136,11647,12042,94
2020, Missouri,Newton County,29145,2020,58648,48383,55041,3607
2010, Missouri,Montgomery County,29139,2010,12236,11713,12064,172
2010, Missouri,St. Charles County,29183,2010,360485,327018,350502,9983
2010, Missouri,Lewis County,29111,2010,10211,9635,10052,159
2020, Missouri,Lewis County,29111,2020,10032,9362,9867,165
2000, Missouri,Lewis County,29111,2000,10494,10066,10417,77
2020, Missouri,Randolph County,29175,2020,24716,21535,24144,572
2000, Missouri,Ralls County,29173,2000,9626,9427,9584,42
2010, Missouri,Randolph County,29175,2010,25414,23133,25001,413
2020, Missouri,Nodaway County,29147,2020,21241,19465,20814,427
2000, Missouri,Nodaway County,29147,2000,21912,21162,21757,155
2000, Missouri,Perry County,29157,2000,18132,17808,18039,93
2020, Missouri,Lafayette County,29107,2020,32984,29627,31937,1047
2000, Missouri,Lafayette County,29107,2000,32960,31485,32574,386
2010, Missouri,Lafayette County,29107,2010,33381,31422,32641,740
2000, Missouri,Scotland County,29199,2000,4983,4924,4941,42
2000, Missouri,Linn County,29115,2000,13754,13476,13650,104
2020, Missouri,Linn County,29115,2020,11874,11136,11585,289
2020, Missouri,Madison County,29123,2020,12626,11615,12284,342
2010, Missouri,Linn County,29115,2010,12761,12401,12568,193
2010, Missouri,Lincoln County,29113,2010,52566,49938,51534,1032
2010, Missouri,Nodaway County,29147,2010,23370,22083,23068,302
2000, Missouri,Lincoln County,29113,2000,38944,37435,38500,444
2010, Missouri,Madison County,29123,2010,12226,11873,11982,244
2000, Missouri,Madison County,29123,2000,11800,11599,11734,66
2000, Missouri,Shannon County,29203,2000,8324,7912,8247,77
2010, Missouri,Ralls County,29173,2010,10167,9892,10069,98
2020, Missouri,Pettis County,29159,2020,42980,35508,38964,4016
2000, Missouri,Monroe County,29137,2000,9311,8814,9259,52
2020, Missouri,Monroe County,29137,2020,8666,7956,8507,159
2010, Missouri,Monroe County,29137,2010,8840,8403,8755,85
2010, Missouri,Pettis County,29159,2010,42201,37839,39155,3046
2000, Missouri,Pettis County,29159,2000,39403,36275,37876,1527
2020, Missouri,Lincoln County,29113,2020,59574,53497,58033,1541
2020, Missouri,New Madrid County,29143,2020,16434,12703,16181,253
2000, Missouri,Ray County,29177,2000,23354,22536,23101,253
2020, Missouri,Dunklin County,29069,2020,28283,22068,26241,2042
2020, Missouri,Benton County,29015,2020,19394,18031,19084,310
2000, Missouri,Wright County,29229,2000,17955,17526,17816,139
2010, Missouri,Wright County,29229,2010,18815,18289,18577,238
2020, Missouri,Carroll County,29033,2020,8495,7944,8363,132
2010, Missouri,Carroll County,29033,2010,9295,8981,9177,118
2000, Missouri,Carroll County,29033,2000,10285,9971,10212,73
2020, Missouri,Cape Girardeau County,29031,2020,81710,67937,79476,2234
2010, Missouri,Cape Girardeau County,29031,2010,75674,67137,74198,1476
2000, Missouri,Cape Girardeau County,29031,2000,68693,63290,68069,624
2010, Missouri,Jackson County,29095,2010,674158,451073,617724,56434
2010, Missouri,Benton County,29015,2010,19056,18508,18765,291
2020, Missouri,Jackson County,29095,2020,717204,435820,639419,77785
2010, Missouri,Webster County,29225,2010,36202,34855,35590,612
2000, Missouri,Webster County,29225,2000,31045,29866,30645,400
2000, Missouri,Jackson County,29095,2000,654880,459061,619720,35160
2010, Missouri,Grundy County,29079,2010,10261,9947,10083,178
2020, Missouri,Grundy County,29079,2020,9808,9225,9567,241
2000, Missouri,Grundy County,29079,2000,10432,10183,10267,165
2020, Missouri,Wright County,29229,2020,18188,16813,17818,370
2010, Missouri,Franklin County,29071,2010,101492,98241,100095,1397
2000, Missouri,Iron County,29093,2000,10697,10348,10635,62
2010, Missouri,Iron County,29093,2010,10630,10250,10497,133
2020, Missouri,Webster County,29225,2020,39085,36178,38295,790
2000, Missouri,Benton County,29015,2000,17180,16830,17027,153
2020, Missouri,Carter County,29035,2020,5202,4837,5105,97
2000, Missouri,Carter County,29035,2000,5941,5739,5869,72
2000, Missouri,Douglas County,29067,2000,13084,12673,12974,110
2020, Missouri,Wayne County,29223,2020,10974,10165,10819,155
2010, Missouri,Wayne County,29223,2010,13521,13138,13381,140
2020, Missouri,Jefferson County,29099,2020,226739,205007,221187,5552
2000, Missouri,Jefferson County,29099,2000,198099,193102,196097,2002
2000, Missouri,Wayne County,29223,2000,13259,12951,13194,65
2020, Missouri,Cass County,29037,2020,107824,91092,102241,5583
2010, Missouri,Cass County,29037,2010,99478,91261,95490,3988
2000, Missouri,Cass County,29037,2000,82092,78499,80276,1816
2020, Missouri,Taney County,29213,2020,56066,47719,51737,4329
2000, Missouri,Taney County,29213,2000,39703,38202,38741,962
2010, Missouri,Jefferson County,29099,2010,218733,211007,215325,3408
2000, Missouri,Howard County,29089,2000,10212,9306,10124,88
2000, Missouri,Dunklin County,29069,2000,33155,29388,32331,824
2010, Missouri,Dunklin County,29069,2010,31953,27179,30226,1727
2010, Missouri,Sullivan County,29211,2010,6714,5957,5466,1248
2020, Missouri,Jasper County,29097,2020,122761,98581,111384,11377
2000, Missouri,Jasper County,29097,2000,104686,96916,101071,3615
2010, Missouri,Jasper County,29097,2010,117404,103596,109377,8027
2000, Missouri,Ste. Genevieve County,29186,2000,17842,17491,17710,132
2020, Missouri,Ste. Genevieve County,29186,2020,18479,17270,18210,269
2010, Missouri,Ste. Genevieve County,29186,2010,18145,17715,17996,149
2010, Missouri,Carter County,29035,2010,6265,6053,6161,104
2020, Missouri,Iron County,29093,2020,9537,8689,9360,177
2000, Missouri,Franklin County,29071,2000,93807,91436,93129,678
2020, Missouri,Barry County,29009,2020,34534,28655,31201,3333
2010, Missouri,Barry County,29009,2010,35597,32792,32852,2745
2020, Missouri,Stone County,29209,2020,31076,28574,30294,782
2000, Missouri,Stone County,29209,2000,28658,27983,28360,298
2020, Missouri,Texas County,29215,2020,24487,22240,23972,515
2010, Missouri,Stone County,29209,2010,32202,31299,31649,553
2020, Missouri,Buchanan County,29021,2020,84793,70025,79193,5600
2000, Missouri,Buchanan County,29021,2000,85998,79744,83912,2086
2010, Missouri,Buchanan County,29021,2010,89201,79443,84527,4674
2000, Missouri,Greene County,29077,2000,240391,224859,235957,4434
2020, Missouri,Greene County,29077,2020,298915,250745,284523,14392
2010, Missouri,Gasconade County,29073,2010,15222,14903,15070,152
2000, Missouri,Gasconade County,29073,2000,15342,15141,15278,64
2020, Missouri,Gasconade County,29073,2020,14794,13756,14605,189
2010, Missouri,Butler County,29023,2010,42794,38860,42128,666
2020, Missouri,Butler County,29023,2020,42130,36033,41229,901
2000, Missouri,Butler County,29023,2000,40867,37663,40455,412
2010, Missouri,Gentry County,29075,2010,6738,6629,6702,36
2000, Missouri,Gentry County,29075,2000,6861,6763,6817,44
2020, Missouri,Gentry County,29075,2020,6162,5883,6072,90
2010, Missouri,Greene County,29077,2010,275174,250866,266967,8207
2000, Missouri,Howell County,29091,2000,37238,35902,36788,450
2010, Missouri,Howell County,29091,2010,40400,38903,39703,697
2020, Missouri,Howell County,29091,2020,39750,36329,38854,896
2020, Missouri,Howard County,29089,2020,10151,8931,9943,208
2020, Missouri,Sullivan County,29211,2020,5999,4680,4945,1054
2020, Missouri,Douglas County,29067,2020,11578,10673,11339,239
2000, Missouri,Sullivan County,29211,2000,7219,6855,6585,634
2020, Missouri,Worth County,29227,2020,1973,1897,1948,25
2000, Missouri,Barry County,29009,2000,34010,31999,32297,1713
2020, Missouri,Franklin County,29071,2020,104682,96383,102477,2205
2010, Missouri,Camden County,29029,2010,44002,42468,42988,1014
2020, Missouri,Camden County,29029,2020,42745,39109,41390,1355
2000, Missouri,Camden County,29029,2000,37051,36190,36705,346
2020, Missouri,Barton County,29011,2020,11637,10462,11371,266
2010, Missouri,Barton County,29011,2010,12402,11788,12171,231
2000, Missouri,Barton County,29011,2000,12541,12156,12422,119
2020, Missouri,Callaway County,29027,2020,44283,38771,43318,965
2020, Missouri,Stoddard County,29207,2020,28672,26836,28106,566
2000, Missouri,Stoddard County,29207,2000,29705,28915,29474,231
2010, Missouri,Callaway County,29027,2010,44332,40778,43625,707
2000, Missouri,Callaway County,29027,2000,40766,37420,40389,377
2010, Missouri,Stoddard County,29207,2010,29968,29150,29612,356
2010, Missouri,Texas County,29215,2010,26008,24332,25583,425
2000, Missouri,Texas County,29215,2000,23003,22190,22782,221
2000, Missouri,Caldwell County,29025,2000,8969,8840,8902,67
2020, Missouri,Caldwell County,29025,2020,8815,8251,8664,151
2010, Missouri,Caldwell County,29025,2010,9424,9091,9281,143
2000, Missouri,Bates County,29013,2000,16653,16208,16474,179
2010, Missouri,Bates County,29013,2010,17049,16464,16774,275
2020, Missouri,Bates County,29013,2020,16042,14925,15707,335
2010, Missouri,Worth County,29227,2010,2171,2121,2148,23
2000, Missouri,Worth County,29227,2000,2382,2358,2375,7
2010, Missouri,Douglas County,29067,2010,13684,13284,13574,110
2010, Missouri,Howard County,29089,2010,10144,9310,10022,122
2010, Missouri,Holt County,29087,2010,4912,4801,4873,39
2020, Missouri,Warren County,29219,2020,35532,31419,34132,1400
2000, Missouri,Hickory County,29085,2000,8940,8717,8872,68
2020, Missouri,Christian County,29043,2020,88842,79916,85830,3012
2000, Missouri,Christian County,29043,2000,54285,52824,53571,714
2010, Missouri,Christian County,29043,2010,77422,74122,75524,1898
2000, Missouri,St. Louis County,29189,2000,1016315,780830,1001738,14577
2010, Missouri,St. Louis city,29510,2010,319294,140267,308164,11130
2020, Missouri,St. Louis city,29510,2020,301578,132292,286173,15405
2000, Missouri,Crawford County,29055,2000,22804,22408,22628,176
2010, Missouri,Crawford County,29055,2010,24696,24020,24331,365
2000, Missouri,Audrain County,29007,2000,25853,23547,25664,189
2010, Missouri,Warren County,29219,2010,32513,30685,31556,957
2000, Missouri,St. Louis city,29510,2000,348189,152666,341167,7022
2020, Missouri,Audrain County,29007,2020,24962,21648,24231,731
2020, Missouri,Henry County,29083,2020,21946,20008,21373,573
2020, Missouri,Bollinger County,29017,2020,10567,9932,10414,153
2000, Missouri,Holt County,29087,2000,5351,5269,5330,21
2010, Missouri,Henry County,29083,2010,22272,21473,21903,369
2020, Missouri,Atchison County,29005,2020,5305,5008,5232,73
2000, Missouri,Atchison County,29005,2000,6430,6237,6387,43
2010, Missouri,Bollinger County,29017,2010,12363,12106,12265,98
2000, Missouri,Boone County,29019,2000,135454,115714,133041,2413
2000, Missouri,Henry County,29083,2000,21997,21251,21796,201
2010, Missouri,Boone County,29019,2010,162642,134621,157747,4895
2020, Missouri,Crawford County,29055,2020,23056,21138,22574,482
2000, Missouri,Warren County,29219,2000,24525,23517,24211,314
2010, Missouri,St. Louis County,29189,2010,998954,701948,973930,25024
2020, Missouri,Andrew County,29003,2020,18135,16907,17744,391
2020, Missouri,Adair County,29001,2020,25314,21843,24653,661
2000, Missouri,Clinton County,29049,2000,18979,18329,18774,205
2020, Missouri,Clinton County,29049,2020,21184,19426,20682,502
2010, Missouri,Clinton County,29049,2010,20743,19802,20421,322
2000, Missouri,Washington County,29221,2000,23344,22286,23174,170
2010, Missouri,Washington County,29221,2010,25195,24142,24940,255
2020, Missouri,Washington County,29221,2020,23514,21465,23287,227
2000, Missouri,Clay County,29047,2000,184006,170129,177412,6594
2020, Missouri,Clay County,29047,2020,253335,198714,234485,18850
2010, Missouri,Clay County,29047,2010,221939,194100,208838,13101
2010, Missouri,Cole County,29051,2010,75990,64137,74195,1795
2010, Missouri,Atchison County,29005,2010,5685,5600,5630,55
2000, Missouri,Cole County,29051,2000,71397,62158,70482,915
2020, Missouri,Cole County,29051,2020,77279,62241,74618,2661
2020, Missouri,Hickory County,29085,2020,8279,7683,8147,132
2020, Missouri,Clark County,29045,2020,6634,6363,6584,50
2020, Missouri,St. Louis County,29189,2020,1004125,632283,966947,37178
2000, Missouri,Clark County,29045,2000,7416,7329,7364,52
2010, Missouri,Clark County,29045,2010,7139,7011,7097,42
2010, Missouri,Hickory County,29085,2010,9627,9338,9536,91
2000, Missouri,Andrew County,29003,2000,16492,16225,16354,138
2010, Missouri,Andrew County,29003,2010,17291,16843,17001,290
2020, Missouri,Cooper County,29053,2020,17103,14850,16781,322
2000, Missouri,Cooper County,29053,2000,16670,14844,16527,143
2010, Missouri,Cooper County,29053,2010,17601,15914,17369,232
2020, Missouri,Boone County,29019,2020,183610,139955,175558,8052
2020, Missouri,Dade County,29057,2020,7569,7038,7434,135
2000, Missouri,Bollinger County,29017,2000,12029,11763,11961,68
2010, Missouri,Dade County,29057,2010,7883,7570,7762,121
2020, Missouri,Daviess County,29061,2020,8430,7977,8317,113
2010, Missouri,Daviess County,29061,2010,8433,8266,8346,87
2020, Missouri,Harrison County,29081,2020,8157,7673,7989,168
2010, Missouri,Harrison County,29081,2010,8957,8738,8816,141
2000, Missouri,DeKalb County,29063,2000,11597,10332,11472,125
2010, Missouri,DeKalb County,29063,2010,12892,11205,12673,219
2000, Missouri,Dade County,29057,2000,7923,7721,7856,67
2010, Missouri,Ray County,29177,2010,23494,22635,23079,415
2010, Missouri,Taney County,29213,2010,51675,48375,49181,2494
2000, Missouri,Chariton County,29041,2000,8438,8100,8391,47
2000, Missouri,Daviess County,29061,2000,8016,7910,7961,55
2020, Missouri,Chariton County,29041,2020,7408,6969,7307,101
2010, Missouri,Dent County,29065,2010,15657,15129,15509,148
2000, Missouri,Dent County,29065,2000,14927,14489,14815,112
2020, Missouri,Dent County,29065,2020,14421,13307,14150,271
2020, Missouri,Cedar County,29039,2020,14188,12996,13927,261
2010, Missouri,Cedar County,29039,2010,13982,13544,13778,204
2000, Missouri,Cedar County,29039,2000,13733,13263,13580,153
2010, Missouri,Vernon County,29217,2010,21159,20409,20823,336
2000, Missouri,Vernon County,29217,2000,20454,19839,20282,172
2020, Missouri,Vernon County,29217,2020,19707,18097,19281,426
2020, Missouri,Holt County,29087,2020,4223,4004,4156,67
2010, Missouri,Chariton County,29041,2010,7831,7571,7791,40
2000, Missouri,Harrison County,29081,2000,8850,8700,8761,89
2020, Missouri,DeKalb County,29063,2020,11029,9780,10802,227
2000, Missouri,Johnson County,29101,2000,48258,43491,46851,1407
2010, Missouri,Johnson County,29101,2010,52595,47344,50984,1611
2010, Missouri,Dallas County,29059,2010,16777,16182,16517,260
2010, Missouri,Audrain County,29007,2010,25529,22931,24864,665
2020, Missouri,Johnson County,29101,2020,54013,45354,51418,2595
2000, Missouri,Dallas County,29059,2000,15661,15262,15514,147
2010, Missouri,Adair County,29001,2010,25607,24066,25084,523
2000, Missouri,Adair County,29001,2000,24977,23932,24662,315
2020, Missouri,Dallas County,29059,2020,17071,15843,16751,320
2020, Montana,Blaine County,30005,2020,7044,2956,6886,158
2010, Montana,Blaine County,30005,2010,6491,3130,6376,115
2020, Montana,Broadwater County,30007,2020,6774,6222,6574,200
2010, Montana,Broadwater County,30007,2010,5612,5401,5486,126
2000, Montana,Broadwater County,30007,2000,4385,4255,4327,58
2000, Montana,Blaine County,30005,2000,7009,3685,6939,70
2020, Montana,Petroleum County,30069,2020,496,466,491,5
2000, Montana,Liberty County,30051,2000,2158,2141,2154,4
2000, Montana,Teton County,30099,2000,6445,6207,6372,73
2010, Montana,Granite County,30039,2010,3079,3001,3035,44
2020, Montana,Granite County,30039,2020,3309,3089,3224,85
2000, Montana,Granite County,30039,2000,2830,2724,2794,36
2010, Montana,Teton County,30099,2010,6073,5847,5997,76
2020, Montana,Teton County,30099,2020,6226,5685,6141,85
2010, Montana,Golden Valley County,30037,2010,884,831,853,31
2020, Montana,Golden Valley County,30037,2020,823,724,788,35
2000, Montana,Golden Valley County,30037,2000,1042,1033,1029,13
2020, Montana,Richland County,30083,2020,11491,10117,10886,605
2010, Montana,Liberty County,30051,2010,2339,2296,2331,8
2000, Montana,Petroleum County,30069,2000,493,489,487,6
2000, Montana,Wibaux County,30109,2000,1068,1047,1064,4
2010, Montana,Richland County,30083,2010,9746,9259,9449,297
2010, Montana,Phillips County,30071,2010,4253,3702,4172,81
2000, Montana,Richland County,30083,2000,9667,9335,9458,209
2010, Montana,Sweet Grass County,30097,2010,3651,3528,3600,51
2020, Montana,Sweet Grass County,30097,2020,3678,3375,3580,98
2020, Montana,Phillips County,30071,2020,4217,3524,4105,112
2000, Montana,Sweet Grass County,30097,2000,3609,3500,3555,54
2020, Montana,Lewis and Clark County,30049,2020,70973,63037,68374,2599
2010, Montana,Lincoln County,30053,2010,19687,18881,19225,462
2000, Montana,Lincoln County,30053,2000,18837,18100,18566,271
2020, Montana,Lincoln County,30053,2020,19677,17948,19116,561
2020, Montana,Liberty County,30051,2020,1959,1856,1946,13
2000, Montana,Lewis and Clark County,30049,2000,55716,53046,54873,843
2010, Montana,Lewis and Clark County,30049,2010,63395,59605,61813,1582
2000, Montana,Silver Bow County,30093,2000,34606,32998,33656,950
2000, Montana,Sheridan County,30091,2000,4105,3982,4061,44
2020, Montana,Silver Bow County,30093,2020,35133,31800,33495,1638
2010, Montana,Silver Bow County,30093,2010,34200,32292,32947,1253
2020, Montana,Sheridan County,30091,2020,3539,3200,3432,107
2010, Montana,Sheridan County,30091,2010,3384,3229,3333,51
2010, Montana,Petroleum County,30069,2010,494,488,489,5
2010, Montana,Wibaux County,30109,2010,1017,993,1004,13
2020, Montana,Wibaux County,30109,2020,937,870,910,27
2000, Montana,Phillips County,30071,2000,4601,4115,4548,53
2010, Montana,Prairie County,30079,2010,1179,1136,1163,16
2020, Montana,Flathead County,30029,2020,104357,94605,101028,3329
2000, Montana,Park County,30067,2000,15694,15168,15406,288
2000, Montana,Mineral County,30061,2000,3884,3673,3823,61
2020, Montana,Mineral County,30061,2020,4535,4097,4388,147
2020, Montana,Dawson County,30021,2020,8940,8080,8652,288
2010, Montana,Dawson County,30021,2010,8966,8582,8788,178
2000, Montana,Dawson County,30021,2000,9059,8826,8978,81
2010, Montana,Deer Lodge County,30023,2010,9298,8660,9027,271
2000, Montana,Deer Lodge County,30023,2000,9417,9028,9262,155
2020, Montana,Deer Lodge County,30023,2020,9421,8638,9161,260
2010, Montana,Mineral County,30061,2010,4223,4007,4143,80
2000, Montana,Prairie County,30079,2000,1199,1175,1191,8
2020, Montana,Meagher County,30059,2020,1927,1789,1881,46
2000, Montana,Meagher County,30059,2000,1932,1878,1903,29
2020, Montana,Cascade County,30013,2020,84414,70265,80402,4012
2010, Montana,Cascade County,30013,2010,81327,72584,78616,2711
2000, Montana,Cascade County,30013,2000,80357,72897,78408,1949
2000, Montana,Carter County,30011,2000,1360,1341,1352,8
2000, Montana,McCone County,30055,2000,1977,1917,1958,19
2020, Montana,McCone County,30055,2020,1729,1606,1697,32
2010, Montana,Meagher County,30059,2010,1891,1852,1863,28
2010, Montana,McCone County,30055,2010,1734,1699,1721,13
2020, Montana,Daniels County,30019,2020,1661,1474,1612,49
2010, Montana,Daniels County,30019,2010,1751,1676,1724,27
2010, Montana,Yellowstone County,30111,2010,147972,134228,141017,6955
2020, Montana,Musselshell County,30065,2020,4730,4339,4584,146
2010, Montana,Musselshell County,30065,2010,4538,4360,4420,118
2000, Montana,Musselshell County,30065,2000,4497,4358,4425,72
2020, Montana,Yellowstone County,30111,2020,164731,139965,154616,10115
2000, Montana,Yellowstone County,30111,2000,129352,120014,124564,4788
2000, Montana,Sanders County,30089,2000,10227,9400,10068,159
2020, Montana,Chouteau County,30015,2020,5895,4214,5736,159
2000, Montana,Daniels County,30019,2000,2017,1937,1985,32
2010, Montana,Chouteau County,30015,2010,5813,4409,5719,94
2010, Montana,Sanders County,30089,2010,11413,10453,11180,233
2020, Montana,Sanders County,30089,2020,12400,10888,12054,346
2020, Montana,Custer County,30017,2020,11867,10838,11505,362
2010, Montana,Custer County,30017,2010,11699,11174,11436,263
2000, Montana,Custer County,30017,2000,11696,11347,11519,177
2010, Montana,Missoula County,30063,2010,109299,101320,106438,2861
2020, Montana,Missoula County,30063,2020,117922,101540,111918,6004
2000, Montana,Missoula County,30063,2000,95802,90073,94259,1543
2000, Montana,Chouteau County,30015,2000,5970,5015,5930,40
2010, Montana,Carter County,30011,2010,1160,1135,1152,8
2020, Montana,Carter County,30011,2020,1415,1347,1404,11
2020, Montana,Valley County,30105,2020,7578,6392,7404,174
2020, Montana,Roosevelt County,30085,2020,10794,3630,10555,239
2010, Montana,Roosevelt County,30085,2010,10425,3736,10293,132
2000, Montana,Gallatin County,30031,2000,67831,65251,66784,1047
2020, Montana,Gallatin County,30031,2020,118960,105886,113065,5895
2010, Montana,Gallatin County,30031,2010,89513,85084,87043,2470
2000, Montana,Roosevelt County,30085,2000,10620,4347,10489,131
2000, Montana,Treasure County,30103,2000,861,830,848,13
2000, Montana,Garfield County,30033,2000,1279,1268,1274,5
2020, Montana,Madison County,30057,2020,8623,8012,8384,239
2010, Montana,Garfield County,30033,2010,1206,1189,1203,3
2020, Montana,Treasure County,30103,2020,762,698,731,31
2010, Montana,Park County,30067,2010,15636,15090,15311,325
2020, Montana,Park County,30067,2020,17191,15849,16681,510
2020, Montana,Toole County,30101,2020,4971,4268,4793,178
2000, Montana,Glacier County,30035,2000,13247,4693,13088,159
2020, Montana,Glacier County,30035,2020,13778,3526,13477,301
2010, Montana,Glacier County,30035,2010,13399,4165,13158,241
2010, Montana,Toole County,30101,2010,5324,4896,5195,129
2010, Montana,Treasure County,30103,2010,718,674,693,25
2000, Montana,Madison County,30057,2000,6851,6647,6721,130
2010, Montana,Madison County,30057,2010,7691,7445,7505,186
2010, Montana,Wheatland County,30107,2010,2168,2078,2136,32
2010, Montana,Valley County,30105,2010,7369,6409,7278,91
2000, Montana,Valley County,30105,2000,7675,6765,7615,60
2000, Montana,Fallon County,30025,2000,2837,2797,2826,11
2020, Montana,Fallon County,30025,2020,3049,2888,2986,63
2010, Montana,Fallon County,30025,2010,2890,2814,2856,34
2000, Montana,Carbon County,30009,2000,9552,9272,9383,169
2010, Montana,Carbon County,30009,2010,10078,9793,9890,188
2020, Montana,Carbon County,30009,2020,10473,9720,10212,261
2020, Montana,Fergus County,30027,2020,11446,10673,11221,225
2010, Montana,Fergus County,30027,2010,11586,11193,11415,171
2000, Montana,Fergus County,30027,2000,11893,11548,11797,96
2010, Montana,Hill County,30041,2010,16096,11896,15723,373
2000, Montana,Flathead County,30029,2000,74471,71689,73410,1061
2010, Montana,Flathead County,30029,2010,90928,86802,88858,2070
2010, Montana,Rosebud County,30087,2010,9233,5664,8920,313
2020, Montana,Rosebud County,30087,2020,8329,4834,8095,234
2000, Montana,Rosebud County,30087,2000,9383,6043,9164,219
2020, Montana,Wheatland County,30107,2020,2069,1877,2001,68
2000, Montana,Wheatland County,30107,2000,2259,2191,2234,25
2000, Montana,Toole County,30101,2000,5267,4945,5206,61
2000, Montana,Hill County,30041,2000,16673,13263,16465,208
2020, Montana,Garfield County,30033,2020,1173,1126,1159,14
2020, Montana,Judith Basin County,30045,2020,2023,1895,1974,49
2020, Montana,Prairie County,30079,2020,1088,1004,1055,33
2010, Montana,Ravalli County,30081,2010,40212,38546,39017,1195
2020, Montana,Lake County,30047,2020,31134,20640,29966,1168
2000, Montana,Lake County,30047,2000,26507,18922,25839,668
2010, Montana,Pondera County,30073,2010,6153,5086,6066,87
2020, Montana,Pondera County,30073,2020,5898,4676,5801,97
2020, Montana,Hill County,30041,2020,16309,11172,15809,500
2000, Montana,Powell County,30077,2000,7180,6643,7040,140
2010, Montana,Lake County,30047,2010,28746,19945,27748,998
2000, Montana,Ravalli County,30081,2000,36070,34883,35392,678
2010, Montana,Powell County,30077,2010,7027,6494,6910,117
2020, Montana,Powell County,30077,2020,6946,6092,6785,161
2000, Montana,Stillwater County,30095,2000,8195,7934,8030,165
2020, Montana,Stillwater County,30095,2020,8963,8216,8694,269
2010, Montana,Stillwater County,30095,2010,9117,8823,8903,214
2000, Montana,Beaverhead County,30001,2000,9202,8821,8956,246
2000, Montana,Pondera County,30073,2000,6424,5374,6370,54
2020, Montana,Beaverhead County,30001,2020,9371,8451,8940,431
2020, Montana,Ravalli County,30081,2020,44174,40362,42590,1584
2000, Montana,Big Horn County,30003,2000,12671,4638,12206,465
2010, Montana,Beaverhead County,30001,2010,9246,8765,8908,338
2020, Montana,Powder River County,30075,2020,1694,1547,1659,35
2010, Montana,Judith Basin County,30045,2010,2072,2036,2048,24
2010, Montana,Big Horn County,30003,2010,12865,4035,12355,510
2020, Montana,Jefferson County,30043,2020,12085,11016,11794,291
2000, Montana,Jefferson County,30043,2000,10049,9654,9900,149
2000, Montana,Judith Basin County,30045,2000,2329,2297,2316,13
2020, Montana,Big Horn County,30003,2020,13124,3520,12609,515
2010, Montana,Powder River County,30075,2010,1743,1656,1719,24
2010, Montana,Jefferson County,30043,2010,11406,10889,11182,224
2000, Montana,Powder River County,30075,2000,1858,1810,1847,11
2010, Nebraska,Red Willow County,31145,2010,11055,10612,10593,462
2010, Nebraska,Knox County,31107,2010,8701,7753,8546,155
2000, Nebraska,Thayer County,31169,2000,6055,5976,5994,61
2000, Nebraska,Perkins County,31135,2000,3200,3126,3126,74
2020, Nebraska,Dundy County,31057,2020,1654,1506,1551,103
2010, Nebraska,Thayer County,31169,2010,5228,5120,5152,76
2020, Nebraska,Thayer County,31169,2020,5034,4817,4898,136
2000, Nebraska,Dundy County,31057,2000,2292,2222,2218,74
2010, Nebraska,Banner County,31007,2010,690,660,664,26
2000, Nebraska,Banner County,31007,2000,819,785,773,46
2010, Nebraska,Saline County,31151,2010,14200,11783,11330,2870
2000, Nebraska,Thurston County,31173,2000,7171,3282,6997,174
2010, Nebraska,Greeley County,31077,2010,2538,2478,2487,51
2020, Nebraska,Greeley County,31077,2020,2188,2102,2136,52
2000, Nebraska,Greeley County,31077,2000,2714,2658,2691,23
2020, Nebraska,Thurston County,31173,2020,6773,2475,6513,260
2010, Nebraska,Thurston County,31173,2010,6940,2801,6750,190
2010, Nebraska,Thomas County,31171,2010,647,635,635,12
2010, Nebraska,Dundy County,31057,2010,2008,1914,1891,117
2020, Nebraska,Thomas County,31171,2020,669,630,640,29
2020, Nebraska,Banner County,31007,2020,674,614,623,51
2010, Nebraska,Valley County,31175,2010,4260,4152,4181,79
2020, Nebraska,Valley County,31175,2020,4059,3865,3943,116
2000, Nebraska,Valley County,31175,2000,4647,4561,4572,75
2000, Nebraska,Adams County,31001,2000,31151,29451,29723,1428
2010, Nebraska,Adams County,31001,2010,31364,28821,28820,2544
2020, Nebraska,Red Willow County,31145,2020,10702,9734,10015,687
2020, Nebraska,Wayne County,31179,2020,9697,8023,8706,991
2000, Nebraska,Thomas County,31171,2000,729,725,723,6
2000, Nebraska,Antelope County,31003,2000,7452,7364,7400,52
2000, Nebraska,Polk County,31143,2000,5639,5578,5578,61
2010, Nebraska,Antelope County,31003,2010,6685,6517,6507,178
2020, Nebraska,Knox County,31107,2020,8391,7018,8206,185
2010, Nebraska,Lincoln County,31111,2010,36288,34229,33686,2602
2020, Nebraska,Lincoln County,31111,2020,34676,30678,31665,3011
2000, Nebraska,Lincoln County,31111,2000,34632,32795,32752,1880
2000, Nebraska,Lancaster County,31109,2000,250291,225426,241854,8437
2010, Nebraska,Lancaster County,31109,2010,285407,248615,268722,16685
2020, Nebraska,Lancaster County,31109,2020,322608,258438,296764,25844
2020, Nebraska,Brown County,31017,2020,2903,2664,2727,176
2020, Nebraska,Cheyenne County,31033,2020,9468,8518,8717,751
2020, Nebraska,Douglas County,31055,2020,584526,398426,503706,80820
2020, Nebraska,Hooker County,31091,2020,711,665,700,11
2000, Nebraska,Hooker County,31091,2000,783,773,775,8
2000, Nebraska,Douglas County,31055,2000,463585,375317,432657,30928
2010, Nebraska,Douglas County,31055,2010,517110,395025,459306,57804
2020, Nebraska,Jefferson County,31095,2020,7240,6671,6879,361
2010, Nebraska,Jefferson County,31095,2010,7547,7323,7347,200
2010, Nebraska,McPherson County,31117,2010,539,529,537,2
2010, Nebraska,Wayne County,31179,2010,9595,9091,9194,401
2010, Nebraska,Madison County,31119,2010,34876,30752,30372,4504
2000, Nebraska,Wayne County,31179,2000,9851,9534,9705,146
2010, Nebraska,Brown County,31017,2010,3145,3088,3116,29
2010, Nebraska,Sheridan County,31161,2010,5469,4629,5298,171
2000, Nebraska,Sheridan County,31161,2000,6198,5461,6107,91
2020, Nebraska,Sheridan County,31161,2020,5127,4143,4905,222
2000, Nebraska,Knox County,31107,2000,9374,8589,9289,85
2020, Nebraska,Cass County,31025,2020,26598,24633,25610,988
2000, Nebraska,Cass County,31025,2000,24334,23821,23979,355
2000, Nebraska,Red Willow County,31145,2000,11448,11167,11167,281
2010, Nebraska,Perkins County,31135,2010,2970,2884,2875,95
2010, Nebraska,Sherman County,31163,2010,3152,3122,3121,31
2000, Nebraska,Sherman County,31163,2000,3318,3268,3284,34
2020, Nebraska,Sherman County,31163,2020,2959,2807,2877,82
2000, Nebraska,Rock County,31149,2000,1756,1739,1747,9
2010, Nebraska,Rock County,31149,2010,1526,1503,1524,2
2020, Nebraska,Rock County,31149,2020,1262,1223,1242,20
2010, Nebraska,Cass County,31025,2010,25241,24457,24633,608
2000, Nebraska,Cheyenne County,31033,2000,9830,9470,9392,438
2000, Nebraska,Brown County,31017,2000,3525,3477,3496,29
2010, Nebraska,Cheyenne County,31033,2010,9998,9404,9388,610
2020, Nebraska,Perkins County,31135,2020,2858,2660,2712,146
2020, Nebraska,Logan County,31113,2020,716,676,693,23
2010, Nebraska,Buffalo County,31019,2010,46102,42746,42670,3432
2000, Nebraska,Arthur County,31005,2000,444,428,438,6
2020, Nebraska,Arthur County,31005,2020,434,400,422,12
2020, Nebraska,Kimball County,31105,2020,3434,3122,3172,262
2000, Nebraska,Butler County,31023,2000,8767,8625,8622,145
2020, Nebraska,Butler County,31023,2020,8369,7725,7887,482
2010, Nebraska,Butler County,31023,2010,8395,8192,8200,195
2020, Nebraska,Saline County,31151,2020,14292,9893,10225,4067
2010, Nebraska,Franklin County,31061,2010,3225,3163,3192,33
2010, Nebraska,Garfield County,31071,2010,2049,2033,2034,15
2020, Nebraska,Franklin County,31061,2020,2889,2760,2807,82
2000, Nebraska,Nemaha County,31127,2000,7576,7394,7500,76
2000, Nebraska,Otoe County,31131,2000,15396,14999,15019,377
2010, Nebraska,Otoe County,31131,2010,15740,14932,14838,902
2020, Nebraska,Otoe County,31131,2020,15912,14172,14650,1262
2020, Nebraska,Nemaha County,31127,2020,7074,6602,6866,208
2000, Nebraska,Kimball County,31105,2000,4089,3966,3953,136
2010, Nebraska,Kimball County,31105,2010,3821,3599,3577,244
2010, Nebraska,Nemaha County,31127,2010,7248,7026,7115,133
2000, Nebraska,Franklin County,31061,2000,3574,3547,3551,23
2020, Nebraska,Garfield County,31071,2020,1813,1758,1789,24
2000, Nebraska,Garfield County,31071,2000,1902,1879,1883,19
2010, Nebraska,Garden County,31069,2010,2057,1987,1977,80
2020, Nebraska,Madison County,31119,2020,35585,28898,30071,5514
2000, Nebraska,Madison County,31119,2000,35226,32179,32184,3042
2000, Nebraska,Seward County,31159,2000,16496,16174,16317,179
2010, Nebraska,Seward County,31159,2010,16750,16315,16478,272
2020, Nebraska,Wheeler County,31183,2020,774,741,754,20
2000, Nebraska,Wheeler County,31183,2000,886,878,881,5
2000, Nebraska,Saline County,31151,2000,13843,12872,12932,911
2010, Nebraska,Furnas County,31065,2010,4959,4804,4827,132
2000, Nebraska,Furnas County,31065,2000,5324,5229,5263,61
2020, Nebraska,Furnas County,31065,2020,4636,4293,4416,220
2020, Nebraska,Gage County,31067,2020,21704,20298,21069,635
2010, Nebraska,Gage County,31067,2010,22311,21610,21926,385
2000, Nebraska,Gage County,31067,2000,22993,22463,22797,196
2020, Nebraska,Seward County,31159,2020,17609,16566,17113,496
2020, Nebraska,Frontier County,31063,2020,2519,2376,2438,81
2010, Nebraska,Frontier County,31063,2010,2756,2711,2721,35
2000, Nebraska,Frontier County,31063,2000,3099,3046,3069,30
2000, Nebraska,Garden County,31069,2000,2292,2254,2259,33
2020, Nebraska,Garden County,31069,2020,1874,1748,1786,88
2020, Nebraska,Webster County,31181,2020,3395,3160,3247,148
2000, Nebraska,Buffalo County,31019,2000,42259,40221,40289,1970
2020, Nebraska,Fillmore County,31059,2020,5551,5227,5374,177
2000, Nebraska,Burt County,31021,2000,7791,7606,7693,98
2020, Nebraska,Loup County,31115,2020,607,565,589,18
2000, Nebraska,Loup County,31115,2000,712,704,700,12
2020, Nebraska,Pawnee County,31133,2020,2544,2461,2505,39
2000, Nebraska,Pawnee County,31133,2000,3087,3052,3066,21
2010, Nebraska,Pawnee County,31133,2010,2773,2708,2738,35
2010, Nebraska,Grant County,31075,2010,614,604,607,7
2020, Nebraska,Grant County,31075,2020,611,580,599,12
2000, Nebraska,Grant County,31075,2000,747,738,737,10
2010, Nebraska,Loup County,31115,2010,632,625,619,13
2000, Nebraska,Scotts Bluff County,31157,2000,36951,32363,30599,6352
2020, Nebraska,Scotts Bluff County,31157,2020,36084,28265,27881,8203
2020, Nebraska,Nance County,31125,2020,3380,3224,3320,60
2000, Nebraska,McPherson County,31117,2000,533,522,525,8
2010, Nebraska,Logan County,31113,2010,763,751,750,13
2000, Nebraska,Logan County,31113,2000,774,763,767,7
2010, Nebraska,Nance County,31125,2010,3735,3659,3670,65
2000, Nebraska,Nance County,31125,2000,4038,3973,3992,46
2020, Nebraska,Buffalo County,31019,2020,50084,43363,45022,5062
2010, Nebraska,Scotts Bluff County,31157,2010,36970,32307,29185,7785
2010, Nebraska,Polk County,31143,2010,5406,5292,5250,156
2020, Nebraska,Polk County,31143,2020,5214,4798,4955,259
2000, Nebraska,Gosper County,31073,2000,2143,2117,2116,27
2020, Nebraska,Platte County,31141,2020,34296,26932,27044,7252
2010, Nebraska,Platte County,31141,2010,32237,29021,27785,4452
2000, Nebraska,Platte County,31141,2000,31662,29854,29590,2072
2020, Nebraska,Howard County,31093,2020,6475,6200,6329,146
2000, Nebraska,Howard County,31093,2000,6567,6481,6501,66
2000, Nebraska,Fillmore County,31059,2000,6634,6485,6524,110
2010, Nebraska,Webster County,31181,2010,3812,3659,3679,133
2010, Nebraska,Keya Paha County,31103,2010,824,817,820,4
2020, Nebraska,Burt County,31021,2020,6722,6248,6550,172
2010, Nebraska,Burt County,31021,2010,6858,6579,6732,126
2010, Nebraska,Wheeler County,31183,2010,818,804,812,6
2000, Nebraska,Webster County,31181,2000,4061,3984,4039,22
2010, Nebraska,Howard County,31093,2010,6274,6122,6165,109
2010, Nebraska,York County,31185,2010,13665,12980,13110,555
2000, Nebraska,York County,31185,2000,14598,14128,14393,205
2020, Nebraska,Keya Paha County,31103,2020,769,737,749,20
2000, Nebraska,Keya Paha County,31103,2000,983,977,945,38
2010, Nebraska,Gosper County,31073,2010,2044,1984,1995,49
2020, Nebraska,Gosper County,31073,2020,1893,1778,1798,95
2010, Nebraska,Fillmore County,31059,2010,5890,5703,5712,178
2020, Nebraska,McPherson County,31117,2020,399,378,396,3
2020, Nebraska,Antelope County,31003,2020,6295,5937,6074,221
2000, Nebraska,Blaine County,31009,2000,583,577,582,1
2010, Nebraska,Blaine County,31009,2010,478,474,478,0
2000, Nebraska,Washington County,31177,2000,18780,18427,18578,202
2000, Nebraska,Cuming County,31039,2000,10203,9783,9644,559
2020, Nebraska,Merrick County,31121,2020,7668,7049,7296,372
2020, Nebraska,Washington County,31177,2020,20865,19518,20246,619
2020, Nebraska,Richardson County,31147,2020,7871,7151,7716,155
2020, Nebraska,Cuming County,31039,2020,9013,7841,7901,1112
2010, Nebraska,Kearney County,31099,2010,6489,6284,6245,244
2010, Nebraska,Keith County,31101,2010,8368,8005,7894,474
2020, Nebraska,Johnson County,31097,2020,5290,4187,4661,629
2000, Nebraska,Merrick County,31121,2000,8204,8066,8036,168
2020, Nebraska,Keith County,31101,2020,8335,7509,7585,750
2010, Nebraska,Johnson County,31097,2010,5217,4546,4782,435
2020, Nebraska,Blaine County,31009,2020,431,397,420,11
2010, Nebraska,Merrick County,31121,2010,7845,7550,7574,271
2010, Nebraska,Cuming County,31039,2010,9139,8518,8385,754
2000, Nebraska,Box Butte County,31013,2000,12158,11044,11228,930
2010, Nebraska,Box Butte County,31013,2010,11308,10149,10151,1157
2010, Nebraska,Harlan County,31083,2010,3423,3367,3378,45
2020, Nebraska,Harlan County,31083,2020,3073,2926,2983,90
2020, Nebraska,Boyd County,31015,2020,1810,1724,1777,33
2010, Nebraska,Clay County,31035,2010,6542,6082,6040,502
2010, Nebraska,Richardson County,31147,2010,8363,7886,8251,112
2020, Nebraska,Cedar County,31027,2020,8380,8064,8194,186
2000, Nebraska,Cedar County,31027,2000,9615,9526,9574,41
2010, Nebraska,Cedar County,31027,2010,8852,8703,8739,113
2000, Nebraska,Richardson County,31147,2000,9531,9116,9431,100
2020, Nebraska,Phelps County,31137,2020,8968,8286,8417,551
2000, Nebraska,Phelps County,31137,2000,9747,9532,9527,220
2010, Nebraska,Phelps County,31137,2010,9188,8899,8815,373
2020, Nebraska,Cherry County,31031,2020,5455,4830,5307,148
2010, Nebraska,Cherry County,31031,2010,5713,5180,5618,95
2020, Nebraska,Box Butte County,31013,2020,10842,9063,9596,1246
2000, Nebraska,Chase County,31029,2000,4068,3979,3929,139
2010, Nebraska,Chase County,31029,2010,3966,3644,3524,442
2020, Nebraska,Chase County,31029,2020,3893,3310,3331,562
2020, Nebraska,Dakota County,31043,2020,21582,11028,12771,8811
2000, Nebraska,Hitchcock County,31087,2000,3111,3060,3067,44
2020, Nebraska,Stanton County,31167,2020,5842,5308,5490,352
2010, Nebraska,Morrill County,31123,2010,5042,4600,4355,687
2020, Nebraska,Adams County,31001,2020,31205,26656,27546,3659
2010, Nebraska,Hitchcock County,31087,2010,2908,2839,2866,42
2020, Nebraska,Sioux County,31165,2020,1135,1065,1092,43
2000, Nebraska,Sioux County,31165,2000,1475,1440,1441,34
2010, Nebraska,Sioux County,31165,2010,1311,1260,1259,52
2020, Nebraska,Morrill County,31123,2020,4555,3892,3907,648
2000, Nebraska,Morrill County,31123,2000,5440,5096,4891,549
2020, Nebraska,York County,31185,2020,14125,12789,13286,839
2000, Nebraska,Pierce County,31139,2000,7857,7751,7801,56
2020, Nebraska,Pierce County,31139,2020,7317,6993,7175,142
2010, Nebraska,Pierce County,31139,2010,7266,7147,7173,93
2020, Nebraska,Hitchcock County,31087,2020,2616,2497,2529,87
2010, Nebraska,Stanton County,31167,2010,6129,5814,5848,281
2000, Nebraska,Harlan County,31083,2000,3786,3743,3757,29
2010, Nebraska,Dawes County,31045,2010,9182,8208,8876,306
2020, Nebraska,Dawes County,31045,2020,8199,7069,7871,328
2020, Nebraska,Kearney County,31099,2020,6688,6159,6303,385
2000, Nebraska,Kearney County,31099,2000,6882,6732,6721,161
2010, Nebraska,Dakota County,31043,2010,21006,14810,13587,7419
2000, Nebraska,Hayes County,31085,2000,1068,1038,1041,27
2010, Nebraska,Hayes County,31085,2010,967,939,934,33
2020, Nebraska,Hayes County,31085,2020,856,768,793,63
2000, Nebraska,Dawson County,31047,2000,24365,20058,18187,6178
2020, Nebraska,Boone County,31011,2020,5379,5091,5196,183
2010, Nebraska,Dawson County,31047,2010,24326,18978,16580,7746
2000, Nebraska,Dakota County,31043,2000,20253,15968,15672,4581
2010, Nebraska,Boone County,31011,2010,5505,5422,5440,65
2000, Nebraska,Boone County,31011,2000,6259,6212,6203,56
2000, Nebraska,Johnson County,31097,2000,4488,4198,4359,129
2020, Nebraska,Dawson County,31047,2020,24111,15098,15468,8643
2000, Nebraska,Stanton County,31167,2000,6455,6243,6306,149
2000, Nebraska,Dawes County,31045,2000,9060,8457,8840,220
2000, Nebraska,Clay County,31035,2000,7039,6868,6794,245
2000, Nebraska,Keith County,31101,2000,8875,8587,8500,375
2000, Nebraska,Saunders County,31155,2000,19830,19530,19625,205
2000, Nebraska,Custer County,31041,2000,11793,11631,11685,108
2020, Nebraska,Deuel County,31049,2020,1838,1709,1738,100
2000, Nebraska,Jefferson County,31095,2000,8333,8201,8224,109
2020, Nebraska,Dixon County,31051,2020,5606,4735,4810,796
2020, Nebraska,Custer County,31041,2020,10545,9920,10157,388
2010, Nebraska,Hamilton County,31081,2010,9124,8955,8943,181
2000, Nebraska,Hamilton County,31081,2000,9403,9255,9296,107
2010, Nebraska,Arthur County,31005,2010,460,439,441,19
2010, Nebraska,Custer County,31041,2010,10939,10663,10723,216
2010, Nebraska,Washington County,31177,2010,20234,19673,19815,419
2000, Nebraska,Boyd County,31015,2000,2438,2411,2436,2
2020, Nebraska,Sarpy County,31153,2020,190604,152525,170549,20055
2000, Nebraska,Dixon County,31051,2000,6339,5999,5991,348
2010, Nebraska,Hall County,31079,2010,58607,48413,44954,13653
2000, Nebraska,Hall County,31079,2000,53534,47467,46037,7497
2010, Nebraska,Dixon County,31051,2010,6000,5548,5378,622
2020, Nebraska,Hall County,31079,2020,62895,43702,43714,19181
2020, Nebraska,Clay County,31035,2020,6104,5502,5581,523
2020, Nebraska,Hamilton County,31081,2020,9429,8894,9109,320
2010, Nebraska,Deuel County,31049,2010,1941,1883,1866,75
2000, Nebraska,Deuel County,31049,2000,2098,2042,2041,57
2000, Nebraska,Cherry County,31031,2000,6148,5791,6091,57
2010, Nebraska,Boyd County,31015,2010,2099,2035,2066,33
2010, Nebraska,Dodge County,31053,2010,36691,33337,33002,3689
2010, Nebraska,Sarpy County,31153,2010,158840,138879,147271,11569
2000, Nebraska,Sarpy County,31153,2000,122595,109335,117237,5358
2020, Nebraska,Dodge County,31053,2020,37167,30548,31084,6083
2020, Nebraska,Colfax County,31037,2020,10582,5839,5589,4993
2000, Nebraska,Holt County,31089,2000,11551,11419,11469,82
2010, Nebraska,Hooker County,31091,2010,736,728,728,8
2020, Nebraska,Saunders County,31155,2020,22278,20897,21693,585
2010, Nebraska,Saunders County,31155,2010,20780,20201,20365,415
2000, Nebraska,Colfax County,31037,2000,10441,8533,7709,2732
2010, Nebraska,Holt County,31089,2010,10435,10132,10130,305
2010, Nebraska,Nuckolls County,31129,2010,4500,4383,4403,97
2020, Nebraska,Nuckolls County,31129,2020,4095,3862,3977,118
2000, Nebraska,Nuckolls County,31129,2000,5057,5002,5006,51
2020, Nebraska,Holt County,31089,2020,10127,9460,9606,521
2010, Nebraska,Colfax County,31037,2010,10515,7635,6200,4315
2000, Nebraska,Dodge County,31053,2000,36160,34678,34739,1421
2000, Nevada,Clark County,32003,2000,1375765,984796,1073622,302143
2010, Nevada,Humboldt County,32013,2010,16528,13053,12490,4038
2010, Nevada,Clark County,32003,2010,1951269,1188112,1382625,568644
2010, Nevada,Eureka County,32011,2010,1987,1775,1749,238
2020, Nevada,Esmeralda County,32009,2020,729,548,590,139
2020, Nevada,Lyon County,32019,2020,59235,44813,48896,10339
2000, Nevada,Eureka County,32011,2000,1651,1474,1493,158
2000, Nevada,Lincoln County,32017,2000,4165,3811,3944,221
2010, Nevada,Lincoln County,32017,2010,5345,4871,5013,332
2010, Nevada,Lander County,32015,2010,5775,4853,4556,1219
2020, Nevada,Storey County,32029,2020,4104,3427,3764,340
2020, Nevada,Mineral County,32021,2020,4554,3001,4046,508
2020, Nevada,Douglas County,32005,2020,49488,40307,43347,6141
2020, Nevada,Eureka County,32011,2020,1855,1577,1677,178
2000, Nevada,Douglas County,32005,2000,41259,37908,38202,3057
2020, Nevada,Washoe County,32031,2020,486492,311769,364288,122204
2000, Nevada,Lyon County,32019,2000,34501,30576,30717,3784
2020, Nevada,Lincoln County,32017,2020,4499,3950,4205,294
2010, Nevada,Lyon County,32019,2010,51980,44164,44306,7674
2010, Nevada,Storey County,32029,2010,4010,3693,3782,228
2010, Nevada,Douglas County,32005,2010,46997,42130,41894,5103
2010, Nevada,Washoe County,32031,2010,421407,324070,327683,93724
2010, Nevada,Esmeralda County,32009,2010,783,661,663,120
2020, Nevada,Clark County,32003,2020,2265461,1016368,1564045,701416
2000, Nevada,White Pine County,32033,2000,9181,7928,8173,1008
2000, Nevada,Storey County,32029,2000,3399,3161,3225,174
2020, Nevada,Humboldt County,32013,2020,17285,12063,12774,4511
2000, Nevada,Humboldt County,32013,2000,16106,13401,13066,3040
2010, Nevada,Nye County,32023,2010,43946,37755,37979,5967
2010, Nevada,White Pine County,32033,2010,10030,8575,8704,1326
2020, Nevada,Nye County,32023,2020,51591,39153,43664,7927
2020, Nevada,White Pine County,32033,2020,9080,6746,7623,1457
2000, Nevada,Esmeralda County,32009,2000,971,796,872,99
2000, Nevada,Nye County,32023,2000,32485,29117,29772,2713
2000, Nevada,Mineral County,32021,2000,5071,3747,4643,428
2000, Nevada,Lander County,32015,2000,5794,4891,4721,1073
2000, Nevada,Washoe County,32031,2000,339486,272985,283185,56301
2000, Nevada,Pershing County,32027,2000,6693,5200,5399,1294
2010, Nevada,Mineral County,32021,2010,4772,3462,4336,436
2000, Nevada,Elko County,32007,2000,45291,37159,36356,8935
2010, Nevada,Elko County,32007,2010,48818,38772,37660,11158
2020, Nevada,Elko County,32007,2020,53702,37435,40110,13592
2010, Nevada,Churchill County,32001,2010,24877,20407,21868,3009
2010, Nevada,Pershing County,32027,2010,6753,5528,5245,1508
2020, Nevada,Pershing County,32027,2020,6650,4455,5151,1499
2010, Nevada,Carson City,32510,2010,55274,44807,43497,11777
2020, Nevada,Carson City,32510,2020,58639,39852,43769,14870
2000, Nevada,Churchill County,32001,2000,23982,20192,21906,2076
2020, Nevada,Lander County,32015,2020,5734,4282,4478,1256
2000, Nevada,Carson City,32510,2000,52457,44744,44991,7466
2020, Nevada,Churchill County,32001,2020,25516,18717,21930,3586
2010, New Hampshire,Coos County,33007,2010,33055,32045,32654,401
2000, New Hampshire,Coos County,33007,2000,33111,32466,32910,201
2000, New Hampshire,Sullivan County,33019,2000,40458,39645,40237,221
2020, New Hampshire,Sullivan County,33019,2020,43063,39420,42241,822
2020, New Hampshire,Cheshire County,33005,2020,76458,69907,74656,1802
2010, New Hampshire,Strafford County,33017,2010,123143,115545,120942,2201
2010, New Hampshire,Belknap County,33001,2010,60088,58059,59364,724
2000, New Hampshire,Strafford County,33017,2000,112233,108073,111078,1155
2000, New Hampshire,Belknap County,33001,2000,56325,54979,55907,418
2010, New Hampshire,Cheshire County,33005,2010,77117,74239,76027,1090
2000, New Hampshire,Cheshire County,33005,2000,73825,72167,73296,529
2020, New Hampshire,Belknap County,33001,2020,63705,59134,62444,1261
2020, New Hampshire,Coos County,33007,2020,31268,28946,30596,672
2020, New Hampshire,Strafford County,33017,2020,130889,115890,126975,3914
2010, New Hampshire,Rockingham County,33015,2010,295223,281966,289081,6142
2000, New Hampshire,Hillsborough County,33011,2000,380841,357615,368675,12166
2020, New Hampshire,Merrimack County,33013,2020,153808,138454,149928,3880
2010, New Hampshire,Merrimack County,33013,2010,146445,139609,144106,2339
2020, New Hampshire,Hillsborough County,33011,2020,422937,350270,389439,33498
2000, New Hampshire,Carroll County,33003,2000,43666,42890,43457,209
2010, New Hampshire,Sullivan County,33019,2010,43742,42421,43249,493
2000, New Hampshire,Rockingham County,33015,2000,277359,268486,274045,3314
2010, New Hampshire,Hillsborough County,33011,2010,400721,362153,379480,21241
2010, New Hampshire,Carroll County,33003,2010,47818,46627,47345,473
2020, New Hampshire,Carroll County,33003,2020,50107,47199,49338,769
2000, New Hampshire,Grafton County,33009,2000,81743,78276,80829,914
2020, New Hampshire,Rockingham County,33015,2020,314176,285715,303919,10257
2020, New Hampshire,Grafton County,33009,2020,91118,81268,88539,2579
2010, New Hampshire,Grafton County,33009,2010,89118,83386,87518,1600
2000, New Hampshire,Merrimack County,33013,2000,136225,132254,134863,1362
2010, New Jersey,Hudson County,34017,2010,634266,342792,366413,267853
2020, New Jersey,Hunterdon County,34019,2020,128947,106790,118018,10929
2020, New Jersey,Warren County,34041,2020,109632,86875,97407,12225
2000, New Jersey,Hudson County,34017,2000,608975,338457,366852,242123
2000, New Jersey,Salem County,34033,2000,64285,52195,61787,2498
2000, New Jersey,Camden County,34007,2000,508932,360756,459766,49166
2010, New Jersey,Camden County,34007,2010,513657,335389,440533,73124
2020, New Jersey,Cumberland County,34011,2020,154152,74606,101098,53054
2000, New Jersey,Somerset County,34035,2000,297490,236042,271679,25811
2010, New Jersey,Cumberland County,34011,2010,156898,98430,114441,42457
2020, New Jersey,Camden County,34007,2020,523485,293198,428230,95255
2020, New Jersey,Hudson County,34017,2020,724854,248561,431835,293019
2010, New Jersey,Somerset County,34035,2010,323444,226608,281353,42091
2010, New Jersey,Salem County,34033,2010,66083,52757,61576,4507
2000, New Jersey,Mercer County,34021,2000,350761,240206,316863,33898
2020, New Jersey,Salem County,34033,2020,64837,46600,58302,6535
2020, New Jersey,Sussex County,34037,2020,144221,121879,129911,14310
2020, New Jersey,Middlesex County,34023,2020,863162,361742,669475,193687
2010, New Jersey,Morris County,34027,2010,492276,406683,435794,56482
2010, New Jersey,Sussex County,34037,2010,149265,139504,139648,9617
2020, New Jersey,Essex County,34013,2020,863728,261487,653375,210353
2010, New Jersey,Essex County,34013,2010,783969,333868,624852,159117
2000, New Jersey,Essex County,34013,2000,793633,352859,671286,122347
2020, New Jersey,Ocean County,34029,2020,637229,534036,570900,66329
2000, New Jersey,Cumberland County,34011,2000,146438,96478,118615,27823
2010, New Jersey,Ocean County,34029,2010,576567,524577,528784,47783
2000, New Jersey,Ocean County,34029,2000,510916,475391,485278,25638
2000, New Jersey,Monmouth County,34025,2000,615301,519261,577126,38175
2010, New Jersey,Atlantic County,34001,2010,274549,179566,228308,46241
2000, New Jersey,Atlantic County,34001,2000,252552,172632,221823,30729
2010, New Jersey,Monmouth County,34025,2010,630380,520716,569441,60939
2020, New Jersey,Monmouth County,34025,2020,643615,476056,562885,80730
2000, New Jersey,Bergen County,34003,2000,884118,693236,792741,91377
2020, New Jersey,Bergen County,34003,2020,955732,543849,751049,204683
2010, New Jersey,Bergen County,34003,2010,905116,650703,759835,145281
2010, New Jersey,Mercer County,34021,2010,366513,225011,311195,55318
2020, New Jersey,Mercer County,34021,2020,387340,178447,303163,84177
2000, New Jersey,Morris County,34027,2000,470212,410042,433586,36626
2000, New Jersey,Sussex County,34037,2000,144166,138015,139344,4822
2000, New Jersey,Burlington County,34005,2000,423394,331898,405762,17632
2010, New Jersey,Hunterdon County,34019,2010,128349,117264,121627,6722
2010, New Jersey,Warren County,34041,2010,108692,98137,101033,7659
2000, New Jersey,Gloucester County,34015,2000,254673,221742,248090,6583
2010, New Jersey,Gloucester County,34015,2010,288288,240890,274576,13712
2020, New Jersey,Gloucester County,34015,2020,302294,230313,280159,22135
2020, New Jersey,Somerset County,34035,2020,345361,185499,287982,57379
2020, New Jersey,Cape May County,34009,2020,95263,81536,87798,7465
2010, New Jersey,Cape May County,34009,2010,97265,87369,91211,6054
2000, New Jersey,Cape May County,34009,2000,102326,93700,98948,3378
2000, New Jersey,Passaic County,34031,2000,489049,304786,342557,146492
2010, New Jersey,Passaic County,34031,2010,501226,314001,315549,185677
2010, New Jersey,Middlesex County,34023,2010,809858,474589,660883,148975
2000, New Jersey,Warren County,34041,2000,102437,96846,98686,3751
2000, New Jersey,Hunterdon County,34019,2000,121989,114563,118618,3371
2020, New Jersey,Atlantic County,34001,2020,274534,156796,220821,53713
2020, New Jersey,Passaic County,34031,2020,524118,229573,300088,224030
2000, New Jersey,Union County,34039,2000,522541,342302,419530,103011
2010, New Jersey,Union County,34039,2010,536499,329052,389795,146704
2020, New Jersey,Union County,34039,2020,575345,236589,379826,195519
2020, New Jersey,Burlington County,34005,2020,461860,303024,421473,40387
2010, New Jersey,Burlington County,34005,2010,448734,331342,419903,28831
2020, New Jersey,Morris County,34027,2020,509285,354824,432624,76661
2000, New Jersey,Middlesex County,34023,2000,750162,513298,648222,101940
2010, New Mexico,Roosevelt County,35041,2010,19846,15252,11933,7913
2010, New Mexico,Sandoval County,35043,2010,131561,89482,85432,46129
2010, New Mexico,Rio Arriba County,35039,2010,40246,20778,11543,28703
2020, New Mexico,Rio Arriba County,35039,2020,40363,13865,13204,27159
2000, New Mexico,Rio Arriba County,35039,2000,41190,23320,11165,30025
2000, New Mexico,Dona Ana County,35013,2000,174682,118478,64017,110665
2010, New Mexico,Otero County,35035,2010,63797,46352,41771,22026
2020, New Mexico,San Miguel County,35047,2020,27201,12382,6711,20490
2010, New Mexico,Quay County,35037,2010,9041,7781,5207,3834
2000, New Mexico,Quay County,35037,2000,10155,8336,6298,3857
2010, New Mexico,Valencia County,35061,2010,76569,56027,31964,44605
2020, New Mexico,Valencia County,35061,2020,76205,39446,30430,45775
2000, New Mexico,Valencia County,35061,2000,66152,44001,29781,36371
2020, New Mexico,Quay County,35037,2020,8746,6181,4898,3848
2000, New Mexico,Eddy County,35015,2000,51658,39438,31635,20023
2020, New Mexico,Curry County,35009,2020,48430,27928,26634,21796
2010, New Mexico,Eddy County,35015,2010,53829,41667,30098,23731
2020, New Mexico,Doña Ana County,35013,2020,219561,104209,71889,147672
2000, New Mexico,Sandoval County,35043,2000,89908,58512,63471,26437
2020, New Mexico,McKinley County,35031,2020,72902,7639,64291,8611
2000, New Mexico,McKinley County,35031,2000,74798,12257,65522,9276
2010, New Mexico,McKinley County,35031,2010,71492,10834,62019,9473
2020, New Mexico,Catron County,35003,2020,3579,2961,2977,602
2000, New Mexico,Catron County,35003,2000,3543,3109,2864,679
2010, New Mexico,Catron County,35003,2010,3725,3344,3016,709
2020, New Mexico,Eddy County,35015,2020,62314,36266,31007,31307
2000, New Mexico,Otero County,35035,2000,62298,45919,42265,20033
2000, New Mexico,San Miguel County,35047,2000,30126,16938,6639,23487
2010, New Mexico,Dona Ana County,35013,2010,209233,154989,71719,137514
2020, New Mexico,Otero County,35035,2020,67839,38167,41687,26152
2000, New Mexico,Curry County,35009,2000,45044,32613,31359,13685
2010, New Mexico,Curry County,35009,2010,48376,33728,29259,19117
2000, New Mexico,Santa Fe County,35049,2000,129292,95053,65887,63405
2010, New Mexico,Santa Fe County,35049,2010,144170,109800,71155,73015
2020, New Mexico,Santa Fe County,35049,2020,154823,88915,80446,74377
2020, New Mexico,Chaves County,35005,2020,65157,36649,28060,37097
2010, New Mexico,Chaves County,35005,2010,65645,46518,31506,34139
2010, New Mexico,San Miguel County,35047,2010,29393,19583,6810,22583
2000, New Mexico,Chaves County,35005,2000,61382,44167,34478,26904
2000, New Mexico,Cibola County,35006,2000,25595,10138,17040,8555
2020, New Mexico,Cibola County,35006,2020,27172,8080,18528,8644
2020, New Mexico,De Baca County,35011,2020,1698,1298,1044,654
2010, New Mexico,Union County,35059,2010,4549,3718,2744,1805
2000, New Mexico,Union County,35059,2000,4174,3355,2709,1465
2020, New Mexico,Union County,35059,2020,4079,2712,2483,1596
2010, New Mexico,De Baca County,35011,2010,2022,1766,1243,779
2000, New Mexico,De Baca County,35011,2000,2240,1882,1450,790
2010, New Mexico,Cibola County,35006,2010,27213,11386,17279,9934
2000, New Mexico,Roosevelt County,35041,2000,18018,13359,12020,5998
2020, New Mexico,Sandoval County,35043,2020,148834,81521,91217,57617
2000, New Mexico,Hidalgo County,35023,2000,5932,4970,2608,3324
2000, New Mexico,Lincoln County,35027,2000,19411,16228,14436,4975
2020, New Mexico,Sierra County,35051,2020,11576,8815,8265,3311
2020, New Mexico,Lincoln County,35027,2020,20269,14263,13773,6496
2010, New Mexico,Lincoln County,35027,2010,20497,17439,14387,6110
2000, New Mexico,Colfax County,35007,2000,14189,11564,7450,6739
2020, New Mexico,Torrance County,35057,2020,15045,9801,8780,6265
2000, New Mexico,Torrance County,35057,2000,16911,12495,10628,6283
2020, New Mexico,Bernalillo County,35001,2020,676444,353144,346963,329481
2000, New Mexico,Mora County,35033,2000,5180,3050,951,4229
2010, New Mexico,Mora County,35033,2010,4881,3462,928,3953
2010, New Mexico,Harding County,35021,2010,695,604,396,299
2020, New Mexico,Lea County,35025,2020,74455,34303,29262,45193
2010, New Mexico,Lea County,35025,2010,64727,48539,31664,33063
2000, New Mexico,Sierra County,35051,2000,13270,11541,9782,3488
2020, New Mexico,Socorro County,35053,2020,16595,8099,8242,8353
2000, New Mexico,San Juan County,35045,2000,113801,60118,96744,17057
2020, New Mexico,San Juan County,35045,2020,121661,50416,98031,23630
2020, New Mexico,Luna County,35029,2020,25427,12797,8757,16670
2000, New Mexico,Luna County,35029,2000,25016,18587,10581,14435
2010, New Mexico,Socorro County,35053,2010,17866,13424,9202,8664
2000, New Mexico,Lea County,35025,2000,55511,37263,33501,22010
2010, New Mexico,Luna County,35029,2010,25095,19511,9672,15423
2010, New Mexico,San Juan County,35045,2010,130044,67048,105268,24776
2020, New Mexico,Mora County,35033,2020,4189,2020,888,3301
2020, New Mexico,Hidalgo County,35023,2020,4178,2655,1788,2390
2010, New Mexico,Sierra County,35051,2010,11988,10265,8636,3352
2000, New Mexico,Socorro County,35053,2000,18078,11365,9268,8810
2020, New Mexico,Roosevelt County,35041,2020,19191,11910,10794,8397
2020, New Mexico,Los Alamos County,35028,2020,19419,14513,15984,3435
2020, New Mexico,Taos County,35055,2020,34489,19084,17059,17430
2020, New Mexico,Guadalupe County,35019,2020,4452,2067,1016,3436
2010, New Mexico,Guadalupe County,35019,2010,4687,3298,957,3730
2010, New Mexico,Hidalgo County,35023,2010,4894,4177,2125,2769
2000, New Mexico,Bernalillo County,35001,2000,556678,393851,323113,233565
2010, New Mexico,Bernalillo County,35001,2010,662564,459660,345475,317089
2020, New Mexico,Harding County,35021,2020,657,428,375,282
2000, New Mexico,Taos County,35055,2000,29979,19118,12609,17370
2000, New Mexico,Los Alamos County,35028,2000,18343,16556,16188,2155
2010, New Mexico,Los Alamos County,35028,2010,17950,15765,15304,2646
2000, New Mexico,Harding County,35021,2000,810,683,446,364
2010, New Mexico,Taos County,35055,2010,32937,22639,14556,18381
2010, New Mexico,Grant County,35017,2010,29514,25058,15262,14252
2020, New Mexico,Grant County,35017,2020,28185,18266,14719,13466
2010, New Mexico,Colfax County,35007,2010,13750,11522,7262,6488
2020, New Mexico,Colfax County,35007,2020,12387,8137,6509,5878
2000, New Mexico,Grant County,35017,2000,31002,23459,15876,15126
2000, New Mexico,Guadalupe County,35019,2000,4680,2530,879,3801
2010, New Mexico,Torrance County,35057,2010,16383,12460,9984,6399
2010, New York,Oneida County,36065,2010,234878,204679,224059,10819
2010, New York,Greene County,36039,2010,49221,44440,46802,2419
2020, New York,Oneida County,36065,2020,232125,185042,216934,15191
2000, New York,Greene County,36039,2000,48195,43740,46120,2075
2020, New York,Livingston County,36051,2020,61834,55442,59113,2721
2010, New York,Tioga County,36107,2010,51125,49556,50431,694
2010, New York,Livingston County,36051,2010,65393,61363,63591,1802
2000, New York,Livingston County,36051,2000,64328,60494,62869,1459
2000, New York,St. Lawrence County,36089,2000,111931,105782,109923,2008
2020, New York,Greene County,36039,2020,47931,40490,44822,3109
2000, New York,Tioga County,36107,2000,51784,50501,51275,509
2010, New York,Madison County,36053,2010,73442,69740,72126,1316
2010, New York,Sullivan County,36105,2010,77547,63560,66993,10554
2020, New York,Tioga County,36107,2020,48455,44557,47338,1117
2020, New York,Nassau County,36059,2020,1395774,817196,1139349,256425
2020, New York,Orange County,36071,2020,401310,248085,311566,89744
2000, New York,Orange County,36071,2000,341367,285721,301629,39738
2010, New York,Orange County,36071,2010,372813,287802,305628,67185
2020, New York,Allegany County,36003,2020,46456,42555,45491,965
2000, New York,Nassau County,36059,2000,1334544,1058285,1201262,133282
2000, New York,Suffolk County,36103,2000,1419369,1200755,1269958,149411
2020, New York,Suffolk County,36103,2020,1525920,1022846,1192961,332959
2010, New York,Essex County,36031,2010,39370,37100,38377,993
2020, New York,Essex County,36031,2020,37381,34102,36403,978
2000, New York,Essex County,36031,2000,38851,36848,38000,851
2000, New York,Schoharie County,36095,2000,31582,30514,30994,588
2020, New York,Richmond County,36085,2020,495747,295519,398787,96960
2000, New York,Delaware County,36025,2000,48055,46346,47072,983
2000, New York,Erie County,36029,2000,950265,780942,919211,31054
2010, New York,Erie County,36029,2010,919040,735244,877309,41731
2020, New York,Erie County,36029,2020,954236,693563,894578,59658
2020, New York,Ontario County,36069,2020,112458,98880,106345,6113
2020, New York,Delaware County,36025,2020,44308,39466,42323,1985
2010, New York,Delaware County,36025,2010,47980,45675,46420,1560
2010, New York,Ontario County,36069,2010,107931,101078,104252,3679
2000, New York,Sullivan County,36105,2000,73966,63103,67127,6839
2000, New York,Ontario County,36069,2000,100224,95256,98075,2149
2000, New York,Onondaga County,36067,2000,458336,388555,447161,11175
2020, New York,Onondaga County,36067,2020,476516,353232,449944,26572
2010, New York,Onondaga County,36067,2010,467026,378885,448197,18829
2010, New York,Richmond County,36085,2010,468730,341677,387679,81051
2020, New York,Saratoga County,36091,2020,235509,206278,226842,8667
2020, New York,Dutchess County,36027,2020,295911,207251,253687,42224
2010, New York,Cayuga County,36011,2010,80026,74042,78130,1896
2010, New York,Dutchess County,36027,2010,297488,238387,266221,31267
2020, New York,Cattaraugus County,36009,2020,77042,68128,75427,1615
2010, New York,Yates County,36123,2010,25348,24647,24927,421
2010, New York,Cattaraugus County,36009,2010,80317,74639,78972,1345
2020, New York,Wyoming County,36121,2020,40531,36046,39041,1490
2020, New York,Jefferson County,36045,2020,116721,96244,108731,7990
2020, New York,Schenectady County,36093,2020,158061,107493,145556,12505
2000, New York,Schenectady County,36093,2000,146555,128631,141916,4639
2010, New York,Washington County,36115,2010,63216,59815,61770,1446
2020, New York,Columbia County,36021,2020,61570,51533,58028,3542
2000, New York,Columbia County,36021,2000,63094,58105,61496,1598
2010, New York,Columbia County,36021,2010,63096,57136,60642,2454
2020, New York,St. Lawrence County,36089,2020,108505,97530,105673,2832
2020, New York,Washington County,36115,2020,61302,55162,59541,1761
2000, New York,Yates County,36123,2000,24621,24103,24393,228
2010, New York,Schuyler County,36097,2010,18343,17803,18109,234
2000, New York,Schuyler County,36097,2000,19224,18548,18989,235
2020, New York,Broome County,36007,2020,198683,158674,188398,10285
2010, New York,Broome County,36007,2010,200600,176444,193822,6778
2010, New York,Schoharie County,36095,2010,32749,31402,31825,924
2000, New York,Broome County,36007,2000,200536,183153,196550,3986
2000, New York,Bronx County,36005,2000,1332650,398003,687945,644705
2010, New York,Bronx County,36005,2010,1385108,386497,643695,741413
2000, New York,Jefferson County,36045,2000,111738,99118,107061,4677
2010, New York,Jefferson County,36045,2010,116229,103047,110086,6143
2020, New York,Bronx County,36005,2020,1472654,207573,666191,806463
2000, New York,Washington County,36115,2000,61042,57973,59810,1232
2020, New York,Schuyler County,36097,2020,17898,16750,17569,329
2010, New York,Suffolk County,36103,2010,1493350,1206297,1247111,246239
2000, New York,Cattaraugus County,36009,2000,83955,79444,83164,791
2010, New York,Schenectady County,36093,2010,154727,123211,145900,8827
2000, New York,Oneida County,36065,2000,235469,212414,227924,7545
2000, New York,Wayne County,36117,2000,93765,87954,91502,2263
2020, New York,Monroe County,36055,2020,759443,521127,686698,72745
2000, New York,Monroe County,36055,2000,735343,581961,696278,39065
2010, New York,Monroe County,36055,2010,744344,566535,690339,54005
2000, New York,Wyoming County,36121,2000,43424,39880,42146,1278
2000, New York,Cayuga County,36011,2000,81963,76501,80352,1611
2000, New York,Allegany County,36003,2000,49927,48444,49473,454
2010, New York,Lewis County,36049,2010,27087,26465,26730,357
2020, New York,Lewis County,36049,2020,26582,25121,26122,460
2000, New York,Saratoga County,36091,2000,200635,192579,197801,2834
2010, New York,Saratoga County,36091,2010,219607,207181,214328,5279
2000, New York,Lewis County,36049,2000,26944,26451,26772,172
2020, New York,Wayne County,36117,2020,91283,80476,86769,4514
2020, New York,Cayuga County,36011,2020,76248,67017,73612,2636
2020, New York,Yates County,36123,2020,24774,23264,24100,674
2010, New York,Wayne County,36117,2010,93772,87148,90296,3476
2020, New York,Madison County,36053,2020,68016,61504,66343,1673
2020, New York,Putnam County,36079,2020,97668,75406,79908,17760
2010, New York,Putnam County,36079,2010,99710,90470,88049,11661
2010, New York,Hamilton County,36041,2010,4836,4705,4785,51
2020, New York,Hamilton County,36041,2020,5107,4785,5007,100
2000, New York,Hamilton County,36041,2000,5379,5257,5322,57
2020, New York,New York County,36061,2020,1694251,847604,1291611,402640
2010, New York,New York County,36061,2010,1585873,911073,1182296,403577
2000, New York,New York County,36061,2000,1537195,835610,1119379,417816
2010, New York,St. Lawrence County,36089,2010,111944,105064,109798,2146
2000, New York,Dutchess County,36027,2000,280150,234385,262090,18060
2010, New York,Wyoming County,36121,2010,42155,38602,40911,1244
2000, New York,Richmond County,36085,2000,443728,344319,390178,53550
2020, New York,Schoharie County,36095,2020,29714,27112,28639,1075
2000, New York,Cortland County,36023,2000,48599,47115,48034,565
2010, New York,Cortland County,36023,2010,49336,46901,48242,1094
2000, New York,Oswego County,36075,2000,122377,118918,120785,1592
2020, New York,Albany County,36001,2020,314848,215496,293253,21595
2010, New York,Ulster County,36111,2010,182493,158184,166584,15909
2020, New York,Ulster County,36111,2020,181851,141728,160732,21119
2020, New York,Cortland County,36023,2020,46809,41250,45151,1658
2020, New York,Herkimer County,36043,2020,60139,55246,58609,1530
2020, New York,Oswego County,36075,2020,117525,107264,113909,3616
2010, New York,Warren County,36113,2010,65707,63391,64529,1178
2010, New York,Steuben County,36101,2010,98990,94315,97619,1371
2000, New York,Ulster County,36111,2000,177749,158042,166808,10941
2010, New York,Oswego County,36075,2010,122109,117632,119557,2552
2000, New York,Westchester County,36119,2000,923459,658858,779335,144124
2010, New York,Westchester County,36119,2010,949113,646471,742081,207032
2010, New York,Niagara County,36063,2010,216469,191673,211775,4694
2020, New York,Steuben County,36101,2020,93584,84953,91866,1718
2010, New York,Tompkins County,36109,2010,101564,83941,97300,4264
2020, New York,Westchester County,36119,2020,1004457,533150,735123,269334
2010, New York,Kings County,36047,2010,2504700,1072041,2008415,496285
2020, New York,Tompkins County,36109,2020,105740,78657,98663,7077
2000, New York,Chemung County,36015,2000,91070,82840,89461,1609
2010, New York,Albany County,36001,2010,304204,237873,289287,14917
2000, New York,Albany County,36001,2000,294565,245060,285486,9079
2010, New York,Genesee County,36037,2010,60079,55787,58463,1616
2000, New York,Franklin County,36033,2000,51134,42970,49081,2053
2020, New York,Franklin County,36033,2020,47555,39036,46168,1387
2010, New York,Otsego County,36077,2010,62259,58935,60338,1921
2000, New York,Clinton County,36019,2000,79894,74562,77930,1964
2010, New York,Herkimer County,36043,2010,64519,62320,63479,1040
2020, New York,Seneca County,36099,2020,33814,29737,32447,1367
2000, New York,Seneca County,36099,2000,33342,31682,32683,659
2010, New York,Seneca County,36099,2010,35251,32591,34299,952
2020, New York,Chenango County,36017,2020,47220,43531,46103,1117
2000, New York,Steuben County,36101,2000,98726,95198,97930,796
2000, New York,Tompkins County,36109,2000,96501,82507,93533,2968
2000, New York,Warren County,36113,2000,63303,61705,62640,663
2000, New York,Chenango County,36017,2000,51401,50191,50853,548
2000, New York,Otsego County,36077,2000,61676,59083,60505,1171
2020, New York,Otsego County,36077,2020,58524,52403,56132,2392
2010, New York,Chenango County,36017,2010,50477,48896,49548,929
2000, New York,Herkimer County,36043,2000,64427,63031,63847,580
2000, New York,Niagara County,36063,2000,219846,199404,216933,2913
2020, New York,Niagara County,36063,2020,212666,175821,204848,7818
2000, New York,Putnam County,36079,2000,95745,89876,89769,5976
2000, New York,Genesee County,36037,2000,60370,57167,59466,904
2020, New York,Genesee County,36037,2020,58388,51541,55636,2752
2020, New York,Warren County,36113,2020,65737,59911,63985,1752
2020, New York,Kings County,36047,2020,2736074,1028774,2219648,516426
2010, New York,Franklin County,36033,2010,51599,43437,50093,1506
2020, New York,Orleans County,36073,2020,40343,34643,38256,2087
2010, New York,Orleans County,36073,2010,42883,38528,41126,1757
2020, New York,Rockland County,36087,2020,338329,214890,271878,66451
2000, New York,Rockland County,36087,2000,286753,220538,257571,29182
2010, New York,Rockland County,36087,2010,311687,228295,262904,48783
2010, New York,Nassau County,36059,2010,1339532,977577,1144177,195355
2000, New York,Montgomery County,36057,2000,49708,47160,46275,3433
2000, New York,Orleans County,36073,2000,44171,39367,42452,1719
2010, New York,Fulton County,36035,2010,55531,52948,54268,1263
2000, New York,Queens County,36081,2000,2229379,982725,1672774,556605
2000, New York,Kings County,36047,2000,2465326,1015728,1977448,487878
2000, New York,Fulton County,36035,2000,55073,52863,54189,884
2020, New York,Fulton County,36035,2020,53324,47775,51190,2134
2010, New York,Queens County,36081,2010,2230722,886053,1616972,613750
2010, New York,Clinton County,36019,2010,82128,75997,80074,2054
2010, New York,Montgomery County,36057,2010,50219,45519,44565,5654
2020, New York,Chemung County,36015,2020,84148,70463,81210,2938
2010, New York,Chemung County,36015,2010,88830,78771,86590,2240
2020, New York,Montgomery County,36057,2020,49532,40209,42220,7312
2020, New York,Queens County,36081,2020,2405464,621475,1737603,667861
2020, New York,Sullivan County,36105,2020,78624,56040,64617,14007
2020, New York,Clinton County,36019,2020,79843,70142,76987,2856
2010, New York,Chautauqua County,36013,2010,134905,124875,126664,8241
2000, New York,Rensselaer County,36083,2000,152538,139002,149313,3225
2000, New York,Chautauqua County,36013,2000,139750,131416,133849,5901
2010, New York,Allegany County,36003,2010,48946,47085,48276,670
2020, New York,Chautauqua County,36013,2020,127657,109333,115888,11769
2010, New York,Rensselaer County,36083,2010,159429,139529,153349,6080
2020, New York,Rensselaer County,36083,2020,161130,126828,151648,9482
2000, New York,Madison County,36053,2000,69441,67006,68707,734
2000, North Carolina,Mecklenburg County,37119,2000,695454,445250,650583,44871
2000, North Carolina,Person County,37145,2000,35623,24504,34877,746
2010, North Carolina,Watauga County,37189,2010,51079,48272,49366,1713
2010, North Carolina,Cherokee County,37039,2010,27444,25700,26756,688
2000, North Carolina,Mitchell County,37121,2000,15687,15353,15376,311
2020, North Carolina,Person County,37145,2020,39097,25554,36902,2195
2020, North Carolina,Mitchell County,37121,2020,14903,13663,14202,701
2000, North Carolina,Guilford County,37081,2000,421048,271686,405063,15985
2020, North Carolina,Halifax County,37083,2020,48622,19304,47168,1454
2010, North Carolina,Stanly County,37167,2010,60585,50623,58419,2166
2010, North Carolina,Mitchell County,37121,2010,15579,14844,14948,631
2000, North Carolina,Dare County,37055,2000,29967,28393,29301,666
2020, North Carolina,Mecklenburg County,37119,2020,1115482,520567,945560,169922
2020, North Carolina,Yancey County,37199,2020,18470,16866,17454,1016
2010, North Carolina,Cleveland County,37045,2010,98078,74123,95322,2756
2010, North Carolina,Mecklenburg County,37119,2010,919628,508946,807684,111944
2000, North Carolina,Wilkes County,37193,2000,65632,61008,63370,2262
2020, North Carolina,Watauga County,37189,2020,54086,45726,50565,3521
2010, North Carolina,Johnston County,37101,2010,168878,125349,147064,21814
2000, North Carolina,Johnston County,37101,2000,121965,95237,112525,9440
2020, North Carolina,Johnston County,37101,2020,215999,142425,181599,34400
2020, North Carolina,Bladen County,37017,2020,29606,16102,27060,2546
2010, North Carolina,Bertie County,37015,2010,21282,7488,21015,267
2020, North Carolina,Cumberland County,37051,2020,334728,141912,295230,39498
2000, North Carolina,Hertford County,37091,2000,22601,8464,22247,354
2010, North Carolina,Halifax County,37083,2010,54691,21890,53539,1152
2000, North Carolina,Halifax County,37083,2000,57370,24424,56791,579
2000, North Carolina,Watauga County,37189,2000,42695,41181,42073,622
2010, North Carolina,Hertford County,37091,2010,24669,8786,24025,644
2020, North Carolina,Richmond County,37153,2020,42946,23969,39874,3072
2000, North Carolina,Bladen County,37017,2000,32278,18469,31080,1198
2000, North Carolina,Cherokee County,37039,2000,24298,23040,23995,303
2010, North Carolina,Bladen County,37017,2010,35190,19806,32688,2502
2020, North Carolina,Cherokee County,37039,2020,28774,25640,27875,899
2020, North Carolina,Cleveland County,37045,2020,99519,71076,95480,4039
2020, North Carolina,Yadkin County,37197,2020,37214,30842,32832,4382
2010, North Carolina,Ashe County,37009,2010,27281,26050,25970,1311
2020, North Carolina,Guilford County,37081,2020,541299,263428,489147,52152
2020, North Carolina,Ashe County,37009,2020,26577,24435,25058,1519
2020, North Carolina,Hertford County,37091,2020,21552,7622,19973,1579
2020, North Carolina,Wilson County,37195,2020,78784,37341,69760,9024
2010, North Carolina,Jones County,37103,2010,10153,6395,9755,398
2000, North Carolina,Henderson County,37089,2000,89173,82505,84293,4880
2020, North Carolina,Hoke County,37093,2020,52082,21031,44395,7687
2000, North Carolina,Currituck County,37053,2000,18190,16445,17929,261
2000, North Carolina,Hoke County,37093,2000,33646,14982,31231,2415
2010, North Carolina,Hoke County,37093,2010,46952,21272,41129,5823
2020, North Carolina,Henderson County,37089,2020,116281,94151,101282,14999
2020, North Carolina,Lee County,37105,2020,63285,38413,50163,13122
2000, North Carolina,Lee County,37105,2000,49040,34343,43325,5715
2010, North Carolina,Lee County,37105,2010,57866,38688,47290,10576
2010, North Carolina,Surry County,37171,2010,73673,64926,66518,7155
2010, North Carolina,Currituck County,37053,2010,23547,21268,22843,704
2020, North Carolina,Currituck County,37053,2020,28100,23878,26882,1218
2000, North Carolina,Surry County,37171,2000,71219,64383,66599,4620
2000, North Carolina,Northampton County,37131,2000,22086,8633,21925,161
2010, North Carolina,Northampton County,37131,2010,22099,8668,21794,305
2020, North Carolina,Northampton County,37131,2020,17471,6915,17118,353
2000, North Carolina,Swain County,37173,2000,12968,8602,12777,191
2010, North Carolina,Avery County,37011,2010,17797,16364,17000,797
2010, North Carolina,Wilson County,37195,2010,81234,42222,73510,7724
2000, North Carolina,Avery County,37011,2000,17167,16129,16754,413
2000, North Carolina,Wake County,37183,2000,627846,454544,593861,33985
2000, North Carolina,Wilson County,37195,2000,73814,41210,69357,4457
2020, North Carolina,Surry County,37171,2020,71359,59307,62863,8496
2000, North Carolina,Clay County,37043,2000,8775,8600,8702,73
2000, North Carolina,Haywood County,37087,2000,54033,52330,53270,763
2020, North Carolina,Avery County,37011,2020,17806,15746,16819,987
2010, North Carolina,Haywood County,37087,2010,59036,56405,57037,1999
2010, North Carolina,Chatham County,37037,2010,63505,48237,55277,8228
2000, North Carolina,Chatham County,37037,2000,49329,36969,44586,4743
2020, North Carolina,Chatham County,37037,2020,76285,54431,65913,10372
2010, North Carolina,Swain County,37173,2010,13981,9315,13441,540
2020, North Carolina,Haywood County,37087,2020,62089,56440,59260,2829
2010, North Carolina,Henderson County,37089,2010,106740,94914,96316,10424
2010, North Carolina,Clay County,37043,2010,10587,10231,10329,258
2020, North Carolina,Clay County,37043,2020,11089,10150,10651,438
2000, North Carolina,Robeson County,37155,2000,123339,40460,117345,5994
2020, North Carolina,Swain County,37173,2020,14117,8638,13525,592
2020, North Carolina,Robeson County,37155,2020,116530,30041,104773,11757
2010, North Carolina,Richmond County,37153,2010,46639,28072,43898,2741
2000, North Carolina,Bertie County,37015,2000,19773,7178,19578,195
2010, North Carolina,Person County,37145,2010,39464,26968,37871,1593
2010, North Carolina,Robeson County,37155,2010,134168,38877,123236,10932
2020, North Carolina,Dare County,37055,2020,36915,32429,34361,2554
2010, North Carolina,Cumberland County,37051,2010,319431,164064,289241,30190
2000, North Carolina,Yadkin County,37197,2000,36348,33638,33991,2357
2000, North Carolina,Cumberland County,37051,2000,302963,167093,282044,20919
2000, North Carolina,Stanly County,37167,2000,58100,49196,56863,1237
2020, North Carolina,Stanly County,37167,2020,62504,49149,59418,3086
2020, North Carolina,Bertie County,37015,2020,17934,6339,17604,330
2010, North Carolina,Dare County,37055,2010,33920,31313,31710,2210
2020, North Carolina,Jones County,37103,2020,9172,5867,8778,394
2000, North Carolina,Davidson County,37057,2000,147246,128184,142481,4765
2010, North Carolina,Davidson County,37057,2010,162878,137359,152470,10408
2000, North Carolina,Ashe County,37009,2000,24384,23691,23794,590
2000, North Carolina,Harnett County,37085,2000,91025,64744,85689,5336
2010, North Carolina,Harnett County,37085,2010,114678,78300,102319,12359
2020, North Carolina,Harnett County,37085,2020,133568,81867,114669,18899
2020, North Carolina,Lenoir County,37107,2020,55122,27113,50757,4365
2000, North Carolina,Richmond County,37153,2000,46564,30193,45245,1319
2020, North Carolina,Davidson County,37057,2020,168930,131922,155028,13902
2010, North Carolina,Lenoir County,37107,2010,59495,31758,55578,3917
2010, North Carolina,Wake County,37183,2010,900993,597546,813071,87922
2000, North Carolina,Lenoir County,37107,2000,59648,33685,57757,1891
2000, North Carolina,Yancey County,37199,2000,17774,17417,17296,478
2000, North Carolina,Davie County,37059,2000,34835,31504,33626,1209
2020, North Carolina,Davie County,37059,2020,42712,35340,39337,3375
2010, North Carolina,Davie County,37059,2010,41240,36100,38744,2496
2020, North Carolina,Wake County,37183,2020,1129410,663832,1001169,128241
2000, North Carolina,Alleghany County,37005,2000,10677,10217,10147,530
2010, North Carolina,McDowell County,37111,2010,44996,40754,42604,2392
2020, North Carolina,Wilkes County,37193,2020,65969,57105,61315,4654
2010, North Carolina,Alamance County,37001,2010,151131,107420,134492,16639
2020, North Carolina,Sampson County,37163,2020,59036,31254,46787,12249
2010, North Carolina,Sampson County,37163,2010,63431,35985,52991,10440
2000, North Carolina,Pasquotank County,37139,2000,34897,19866,34468,429
2000, North Carolina,Sampson County,37163,2000,60161,35955,53684,6477
2020, North Carolina,Jackson County,37099,2020,43109,33426,39817,3292
2000, North Carolina,Jackson County,37099,2000,33121,28378,32544,577
2010, North Carolina,Jackson County,37099,2010,40271,33489,38233,2038
2010, North Carolina,Pasquotank County,37139,2010,40661,23059,39019,1642
2000, North Carolina,Graham County,37075,2000,7993,7346,7933,60
2020, North Carolina,Pasquotank County,37139,2020,40568,22019,38331,2237
2000, North Carolina,Alamance County,37001,2000,130800,98900,121965,8835
2020, North Carolina,Alexander County,37003,2020,36444,31284,34608,1836
2000, North Carolina,Alexander County,37003,2000,33603,30915,32762,841
2020, North Carolina,Tyrrell County,37177,2020,3245,1903,2973,272
2020, North Carolina,Alamance County,37001,2020,171415,105847,146712,24703
2000, North Carolina,Tyrrell County,37177,2000,4149,2343,3999,150
2010, North Carolina,Tyrrell County,37177,2010,4407,2403,4167,240
2020, North Carolina,Gates County,37073,2020,10478,6762,10277,201
2010, North Carolina,Alexander County,37003,2010,37198,33324,35597,1601
2010, North Carolina,Yadkin County,37197,2010,38406,34007,34657,3749
2010, North Carolina,Forsyth County,37067,2010,350670,218517,308895,41775
2010, North Carolina,Montgomery County,37123,2010,27798,19162,23872,3926
2000, North Carolina,Union County,37179,2000,123677,102441,116040,7637
2010, North Carolina,New Hanover County,37129,2010,202667,160298,191951,10716
2000, North Carolina,New Hanover County,37129,2000,160307,128098,157031,3276
2020, North Carolina,Nash County,37127,2020,94970,47378,87648,7322
2010, North Carolina,Guilford County,37081,2010,488406,278525,453580,34826
2010, North Carolina,Burke County,37023,2010,90912,76716,86278,4634
2010, North Carolina,Nash County,37127,2010,95840,53531,89825,6015
2020, North Carolina,Orange County,37135,2020,148696,99091,132884,15812
2000, North Carolina,Montgomery County,37123,2000,26822,18527,24025,2797
2020, North Carolina,Montgomery County,37123,2020,25751,16917,21827,3924
2020, North Carolina,Union County,37179,2020,238267,165562,208157,30110
2010, North Carolina,Orange County,37135,2010,133801,99495,122784,11017
2020, North Carolina,Graham County,37075,2020,8030,6913,7811,219
2010, North Carolina,Graham County,37075,2010,8861,8004,8667,194
2010, North Carolina,Polk County,37149,2010,20510,18633,19388,1122
2010, North Carolina,Union County,37179,2010,201292,158954,180325,20967
2010, North Carolina,Rowan County,37159,2010,138428,105923,127784,10644
2000, North Carolina,Rowan County,37159,2000,130340,104294,124971,5369
2020, North Carolina,Rowan County,37159,2020,146875,102693,130935,15940
2020, North Carolina,Polk County,37149,2020,19328,16934,18302,1026
2000, North Carolina,Polk County,37149,2000,18324,16906,17773,551
2000, North Carolina,Orange County,37135,2000,118227,92272,112954,5273
2010, North Carolina,Wayne County,37191,2010,122623,72135,110461,12162
2000, North Carolina,Forsyth County,37067,2000,306067,209552,286490,19577
2000, North Carolina,Camden County,37029,2000,6885,5551,6836,49
2010, North Carolina,Stokes County,37169,2010,47401,44021,46147,1254
2010, North Carolina,Transylvania County,37175,2010,33090,30577,32126,964
2020, North Carolina,Caldwell County,37027,2020,80652,68859,75729,4923
2010, North Carolina,Caldwell County,37027,2010,83029,74925,79233,3796
2000, North Carolina,Caldwell County,37027,2000,77415,71017,75488,1927
2000, North Carolina,Stokes County,37169,2000,44711,41774,43875,836
2010, North Carolina,Pamlico County,37137,2010,13144,10032,12732,412
2000, North Carolina,Anson County,37007,2000,25275,12519,25064,211
2000, North Carolina,Cleveland County,37045,2000,96287,73955,94854,1433
2020, North Carolina,Hyde County,37095,2020,4589,2956,4242,347
2000, North Carolina,Pamlico County,37137,2000,12934,9464,12763,171
2000, North Carolina,Cabarrus County,37025,2000,131063,109127,124443,6620
2020, North Carolina,Pamlico County,37137,2020,12276,9216,11780,496
2000, North Carolina,Beaufort County,37013,2000,44958,30768,43503,1455
2020, North Carolina,Beaufort County,37013,2020,44652,29817,41219,3433
2010, North Carolina,Beaufort County,37013,2010,47759,32551,44593,3166
2010, North Carolina,Cabarrus County,37025,2010,178011,134149,161244,16767
2020, North Carolina,Madison County,37115,2020,21193,19373,20445,748
2010, North Carolina,Madison County,37115,2010,20764,20035,20341,423
2000, North Carolina,Madison County,37115,2000,19635,19169,19369,266
2020, North Carolina,Cabarrus County,37025,2020,225804,137756,198541,27263
2020, North Carolina,Forsyth County,37067,2020,382590,214877,327902,54688
2000, North Carolina,Transylvania County,37175,2000,29334,27476,29036,298
2000, North Carolina,Warren County,37185,2000,19972,7769,19655,317
2000, North Carolina,Gates County,37073,2000,10516,6213,10435,81
2000, North Carolina,Iredell County,37097,2000,122660,100785,118478,4182
2010, North Carolina,Iredell County,37097,2010,159437,128646,148593,10844
2010, North Carolina,Gates County,37073,2010,12197,7768,12024,173
2000, North Carolina,Gaston County,37071,2000,190365,157965,184646,5719
2010, North Carolina,Gaston County,37071,2010,206086,161166,193885,12201
2020, North Carolina,Camden County,37029,2020,10355,8312,10015,340
2010, North Carolina,Camden County,37029,2010,9980,8193,9765,215
2020, North Carolina,Gaston County,37071,2020,227943,156794,207875,20068
2020, North Carolina,Warren County,37185,2020,18642,7253,17903,739
2010, North Carolina,Macon County,37113,2010,33922,31811,31692,2230
2020, North Carolina,Franklin County,37069,2020,68573,43473,61611,6962
2000, North Carolina,Franklin County,37069,2000,47260,31190,45160,2100
2010, North Carolina,Franklin County,37069,2010,60619,40003,55843,4776
2020, North Carolina,Iredell County,37097,2020,186693,139369,170916,15777
2010, North Carolina,Warren County,37185,2010,20972,8128,20280,692
2020, North Carolina,Macon County,37113,2020,37014,32099,33516,3498
2020, North Carolina,Transylvania County,37175,2020,32986,28957,31288,1698
2000, North Carolina,Hyde County,37095,2000,5826,3650,5695,131
2010, North Carolina,Hyde County,37095,2010,5810,3718,5399,411
2000, North Carolina,Macon County,37113,2000,29811,28969,29357,454
2020, North Carolina,Columbus County,37047,2020,50623,30380,48010,2613
2000, North Carolina,Nash County,37127,2000,87420,54152,84481,2939
2010, North Carolina,Martin County,37117,2010,24505,13019,23736,769
2020, North Carolina,Pitt County,37147,2020,170243,88790,157275,12968
2000, North Carolina,Vance County,37181,2000,42954,20709,40997,1957
2010, North Carolina,Vance County,37181,2010,45422,20058,42371,3051
2020, North Carolina,Vance County,37181,2020,42578,16682,38861,3717
2000, North Carolina,Carteret County,37031,2000,59383,53611,58348,1035
2010, North Carolina,Carteret County,37031,2010,66469,59346,64228,2241
2000, North Carolina,McDowell County,37111,2000,42151,38853,40937,1214
2020, North Carolina,McDowell County,37111,2020,44578,38356,41631,2947
2010, North Carolina,Washington County,37187,2010,13228,6084,12762,466
2010, North Carolina,Moore County,37125,2010,88247,70913,82986,5261
2000, North Carolina,Jones County,37103,2000,10381,6329,10099,282
2020, North Carolina,Moore County,37125,2020,99727,77010,92362,7365
2020, North Carolina,Carteret County,37031,2020,67686,58255,64567,3119
2000, North Carolina,Brunswick County,37019,2000,73143,60200,71183,1960
2000, North Carolina,Craven County,37049,2000,91436,63952,87759,3677
2010, North Carolina,Craven County,37049,2010,103505,72441,97233,6272
2020, North Carolina,Scotland County,37165,2020,34174,14402,33068,1106
2020, North Carolina,Brunswick County,37019,2020,136693,112307,129273,7420
2020, North Carolina,Craven County,37049,2020,100720,66703,93525,7195
2000, North Carolina,Burke County,37023,2000,89148,76678,85968,3180
2010, North Carolina,Duplin County,37061,2010,58505,33449,46446,12059
2020, North Carolina,Anson County,37007,2020,22055,10692,21390,665
2010, North Carolina,Anson County,37007,2010,26948,12707,26136,812
2000, North Carolina,Washington County,37187,2000,13723,6626,13412,311
2000, North Carolina,Pitt County,37147,2000,133798,83061,129582,4216
2010, North Carolina,Wilkes County,37193,2010,69340,62824,65568,3772
2010, North Carolina,Yancey County,37199,2010,17818,16967,17004,814
2020, North Carolina,Rutherford County,37161,2020,64444,52808,61158,3286
2000, North Carolina,Rutherford County,37161,2000,62899,54592,61763,1136
2010, North Carolina,Rutherford County,37161,2010,67810,58221,65413,2397
2010, North Carolina,Catawba County,37035,2010,154358,126151,141326,13032
2000, North Carolina,Catawba County,37035,2000,141685,120422,133799,7886
2020, North Carolina,Catawba County,37035,2020,160610,118946,143233,17377
2010, North Carolina,Caswell County,37033,2010,23719,14819,22975,744
2020, North Carolina,Alleghany County,37005,2020,10888,9544,9600,1288
2020, North Carolina,Duplin County,37061,2020,48715,26084,37902,10813
2000, North Carolina,Caswell County,37033,2000,23501,14352,23086,415
2020, North Carolina,Caswell County,37033,2020,22736,14232,21734,1002
2000, North Carolina,Randolph County,37151,2000,130454,116370,121808,8646
2020, North Carolina,Randolph County,37151,2020,144171,111459,125120,19051
2020, North Carolina,Lincoln County,37109,2020,86810,72716,80398,6412
2010, North Carolina,Lincoln County,37109,2010,78265,69940,73027,5238
2000, North Carolina,Lincoln County,37109,2000,63780,57557,60124,3656
2020, North Carolina,Perquimans County,37143,2020,13005,9412,12696,309
2000, North Carolina,Perquimans County,37143,2000,11368,8051,11300,68
2010, North Carolina,Perquimans County,37143,2010,13453,9694,13167,286
2010, North Carolina,Pitt County,37147,2010,168148,99075,158946,9202
2010, North Carolina,Randolph County,37151,2010,141752,121169,127054,14698
2010, North Carolina,Alleghany County,37005,2010,11155,10288,10151,1004
2000, North Carolina,Duplin County,37061,2000,49063,28785,41637,7426
2000, North Carolina,Granville County,37077,2000,48498,29459,46547,1951
2010, North Carolina,Granville County,37077,2010,59916,36205,55434,4482
2020, North Carolina,Granville County,37077,2020,60992,34579,54781,6211
2010, North Carolina,Brunswick County,37019,2010,107431,89193,101882,5549
2020, North Carolina,Washington County,37187,2020,11003,4999,10632,371
2000, North Carolina,Wayne County,37191,2000,113329,69452,107725,5604
2010, North Carolina,Columbus County,37047,2010,58098,35735,55436,2662
2000, North Carolina,Columbus County,37047,2000,54749,34737,53480,1269
2020, North Carolina,Rockingham County,37157,2020,91096,65434,85010,6086
2000, North Carolina,Rockingham County,37157,2000,91928,71087,89103,2825
2000, North Carolina,Edgecombe County,37065,2000,55606,22278,54052,1554
2010, North Carolina,Onslow County,37133,2010,177772,131590,159876,17896
2000, North Carolina,Onslow County,37133,2000,150355,108351,139459,10896
2010, North Carolina,Rockingham County,37157,2010,93643,70875,88484,5159
2020, North Carolina,New Hanover County,37129,2020,225702,170837,208402,17300
2000, North Carolina,Buncombe County,37021,2000,206330,183761,200600,5730
2010, North Carolina,Buncombe County,37021,2010,238318,208192,224064,14254
2020, North Carolina,Buncombe County,37021,2020,269452,218867,247530,21922
2020, North Carolina,Burke County,37023,2020,87570,69671,80386,7184
2020, North Carolina,Martin County,37117,2020,22031,11624,21136,895
2000, North Carolina,Martin County,37117,2000,25593,13447,25065,528
2020, North Carolina,Onslow County,37133,2020,204576,137072,176935,27641
2020, North Carolina,Edgecombe County,37065,2020,48900,17631,46194,2706
2020, North Carolina,Stokes County,37169,2020,44520,39966,43064,1456
2000, North Carolina,Pender County,37141,2000,41082,29882,39586,1496
2010, North Carolina,Greene County,37079,2010,21362,10850,18308,3054
2020, North Carolina,Greene County,37079,2020,20451,9992,17515,2936
2010, North Carolina,Edgecombe County,37065,2010,56552,21923,54448,2104
2000, North Carolina,Chowan County,37041,2000,14526,8794,14307,219
2010, North Carolina,Durham County,37063,2010,267587,124274,231510,36077
2000, North Carolina,Durham County,37063,2000,223314,113698,206275,17039
2020, North Carolina,Chowan County,37041,2020,13708,8351,13178,530
2010, North Carolina,Chowan County,37041,2010,14793,9174,14326,467
2020, North Carolina,Durham County,37063,2020,324833,139231,274729,50104
2010, North Carolina,Scotland County,37165,2010,36157,16822,35403,754
2000, North Carolina,Scotland County,37165,2000,35998,18535,35575,423
2020, North Carolina,Wayne County,37191,2020,117333,62452,102406,14927
2000, North Carolina,Moore County,37125,2000,74769,60002,71788,2981
2020, North Carolina,Pender County,37141,2020,60203,45305,55221,4982
2010, North Carolina,Pender County,37141,2010,52217,39756,49023,3194
2000, North Carolina,Greene County,37079,2000,18974,9835,17463,1511
2020, North Dakota,Morton County,38059,2020,33291,29150,31979,1312
2010, North Dakota,Kidder County,38043,2010,2435,2344,2364,71
2020, North Dakota,Kidder County,38043,2020,2394,2278,2342,52
2010, North Dakota,Morton County,38059,2010,27471,25725,27071,400
2000, North Dakota,Mountrail County,38061,2000,6631,4376,6544,87
2020, North Dakota,Mountrail County,38061,2020,9809,5706,9041,768
2010, North Dakota,Nelson County,38063,2010,3126,3037,3093,33
2020, North Dakota,Nelson County,38063,2020,3015,2863,2946,69
2000, North Dakota,Nelson County,38063,2000,3715,3662,3709,6
2000, North Dakota,Morton County,38059,2000,25303,24246,25139,164
2000, North Dakota,Ward County,38101,2000,58795,54327,57670,1125
2010, North Dakota,Ward County,38101,2010,61675,55718,59806,1869
2020, North Dakota,Ward County,38101,2020,69919,57038,65329,4590
2010, North Dakota,Mountrail County,38061,2010,7673,5035,7387,286
2000, North Dakota,Kidder County,38043,2000,2753,2739,2737,16
2000, North Dakota,Billings County,38007,2000,888,877,885,3
2000, North Dakota,Walsh County,38099,2000,12389,11752,11689,700
2010, North Dakota,Stutsman County,38093,2010,21100,20163,20739,361
2020, North Dakota,Golden Valley County,38033,2020,1736,1620,1688,48
2000, North Dakota,Golden Valley County,38033,2000,1924,1881,1904,20
2010, North Dakota,Golden Valley County,38033,2010,1680,1637,1645,35
2000, North Dakota,Burleigh County,38015,2000,69416,65966,68948,468
2010, North Dakota,Burleigh County,38015,2010,81308,75634,80322,986
2020, North Dakota,Burleigh County,38015,2020,98458,85148,95374,3084
2020, North Dakota,Burke County,38013,2020,2201,2082,2142,59
2020, North Dakota,Grand Forks County,38035,2020,73170,60056,69513,3657
2010, North Dakota,Grand Forks County,38035,2010,66861,60358,64910,1951
2000, North Dakota,Grand Forks County,38035,2000,66109,61479,64750,1359
2000, North Dakota,Stutsman County,38093,2000,21908,21367,21704,204
2000, North Dakota,Burke County,38013,2000,2242,2225,2234,8
2010, North Dakota,Burke County,38013,2010,1968,1924,1931,37
2020, North Dakota,Grant County,38037,2020,2301,2176,2275,26
2010, North Dakota,Grant County,38037,2010,2394,2328,2387,7
2000, North Dakota,Grant County,38037,2000,2841,2753,2824,17
2020, North Dakota,Stutsman County,38093,2020,21593,19722,21000,593
2010, North Dakota,Logan County,38047,2010,1990,1959,1978,12
2010, North Dakota,Rolette County,38079,2010,13937,2825,13804,133
2000, North Dakota,Rolette County,38079,2000,13674,3435,13564,110
2020, North Dakota,LaMoure County,38045,2020,4093,3923,4005,88
2000, North Dakota,LaMoure County,38045,2000,4701,4665,4675,26
2010, North Dakota,LaMoure County,38045,2010,4139,4077,4105,34
2000, North Dakota,Wells County,38103,2000,5102,5057,5087,15
2010, North Dakota,Wells County,38103,2010,4207,4160,4186,21
2000, North Dakota,Foster County,38031,2000,3759,3722,3752,7
2010, North Dakota,Foster County,38031,2010,3343,3291,3314,29
2020, North Dakota,Foster County,38031,2020,3397,3212,3331,66
2020, North Dakota,Wells County,38103,2020,3982,3801,3944,38
2010, North Dakota,Richland County,38077,2010,16321,15507,16050,271
2000, North Dakota,Richland County,38077,2000,17998,17428,17875,123
2020, North Dakota,Richland County,38077,2020,16529,14874,15955,574
2020, North Dakota,Traill County,38097,2020,7997,7410,7700,297
2000, North Dakota,Traill County,38097,2000,8477,8249,8292,185
2010, North Dakota,Traill County,38097,2010,8121,7809,7907,214
2010, North Dakota,Towner County,38095,2010,2246,2173,2236,10
2000, North Dakota,Towner County,38095,2000,2876,2799,2871,5
2020, North Dakota,Rolette County,38079,2020,12187,2319,12050,137
2020, North Dakota,Logan County,38047,2020,1876,1778,1841,35
2000, North Dakota,Logan County,38047,2000,2308,2289,2292,16
2000, North Dakota,Pembina County,38067,2000,8585,8198,8321,264
2000, North Dakota,Bowman County,38011,2000,3242,3209,3220,22
2010, North Dakota,Bowman County,38011,2010,3151,3085,3073,78
2020, North Dakota,Bowman County,38011,2020,2993,2793,2864,129
2010, North Dakota,Bottineau County,38009,2010,6429,6112,6347,82
2020, North Dakota,Bottineau County,38009,2020,6379,5754,6238,141
2000, North Dakota,Bottineau County,38009,2000,7149,6950,7114,35
2010, North Dakota,Sioux County,38085,2010,4153,525,4071,82
2020, North Dakota,Sioux County,38085,2020,3898,401,3835,63
2000, North Dakota,Pierce County,38069,2000,4675,4605,4647,28
2010, North Dakota,Pierce County,38069,2010,4357,4100,4313,44
2020, North Dakota,Pierce County,38069,2020,3990,3637,3918,72
2020, North Dakota,Hettinger County,38041,2020,2489,2327,2455,34
2000, North Dakota,Hettinger County,38041,2000,2715,2686,2709,6
2010, North Dakota,Hettinger County,38041,2010,2477,2382,2465,12
2000, North Dakota,Sioux County,38085,2000,4044,580,3979,65
2020, North Dakota,Billings County,38007,2020,945,911,923,22
2010, North Dakota,Billings County,38007,2010,783,772,779,4
2020, North Dakota,Slope County,38087,2020,706,680,698,8
2010, North Dakota,Slope County,38087,2010,727,709,715,12
2000, North Dakota,Benson County,38005,2000,6964,3541,6909,55
2020, North Dakota,Benson County,38005,2020,5964,2542,5875,89
2020, North Dakota,Pembina County,38067,2020,6844,6173,6601,243
2010, North Dakota,Pembina County,38067,2010,7413,7077,7223,190
2010, North Dakota,Adams County,38001,2010,2343,2279,2323,20
2000, North Dakota,Adams County,38001,2000,2593,2554,2586,7
2010, North Dakota,Ramsey County,38071,2010,11451,10044,11314,137
2020, North Dakota,Ramsey County,38071,2020,11605,9438,11331,274
2000, North Dakota,Ramsey County,38071,2000,12066,11138,12003,63
2000, North Dakota,Sheridan County,38083,2000,1710,1697,1704,6
2010, North Dakota,Barnes County,38003,2010,11066,10668,10943,123
2020, North Dakota,Sheridan County,38083,2020,1265,1191,1255,10
2010, North Dakota,Benson County,38005,2010,6660,2889,6583,77
2020, North Dakota,Griggs County,38039,2020,2306,2205,2282,24
2010, North Dakota,Griggs County,38039,2010,2420,2392,2411,9
2000, North Dakota,Griggs County,38039,2000,2754,2735,2743,11
2000, North Dakota,Slope County,38087,2000,767,765,766,1
2020, North Dakota,Williams County,38105,2020,40950,31854,37053,3897
2010, North Dakota,Williams County,38105,2010,22398,20639,21962,436
2000, North Dakota,Williams County,38105,2000,19761,18367,19576,185
2010, North Dakota,Sheridan County,38083,2010,1321,1278,1305,16
2020, North Dakota,Barnes County,38003,2020,10853,10025,10668,185
2020, North Dakota,Towner County,38095,2020,2162,1987,2128,34
2010, North Dakota,Cass County,38017,2010,149778,137308,146763,3015
2000, North Dakota,McKenzie County,38053,2000,5737,4438,5679,58
2000, North Dakota,Cass County,38017,2000,123138,117106,121620,1518
2020, North Dakota,Cass County,38017,2020,184525,151307,178343,6182
2010, North Dakota,McIntosh County,38051,2010,2809,2755,2771,38
2020, North Dakota,McIntosh County,38051,2020,2530,2390,2477,53
2000, North Dakota,McIntosh County,38051,2000,3390,3352,3362,28
2020, North Dakota,McKenzie County,38053,2020,14704,10638,13172,1532
2010, North Dakota,McHenry County,38049,2010,5395,5275,5315,80
2020, North Dakota,McHenry County,38049,2020,5345,5054,5247,98
2020, North Dakota,Stark County,38089,2020,33646,28924,31372,2274
2010, North Dakota,Cavalier County,38019,2010,3993,3902,3969,24
2020, North Dakota,Dunn County,38025,2020,4095,3277,3988,107
2010, North Dakota,Dunn County,38025,2010,3536,3003,3498,38
2000, North Dakota,Ransom County,38073,2000,5890,5768,5842,48
2000, North Dakota,McHenry County,38049,2000,5987,5911,5963,24
2000, North Dakota,Dunn County,38025,2000,3600,3117,3573,27
2010, North Dakota,McKenzie County,38053,2010,6360,4792,6221,139
2020, North Dakota,Mercer County,38057,2020,8350,7622,8132,218
2000, North Dakota,Dickey County,38021,2000,5757,5629,5679,78
2010, North Dakota,Dickey County,38021,2010,5289,5104,5189,100
2020, North Dakota,Dickey County,38021,2020,4999,4628,4800,199
2020, North Dakota,Sargent County,38081,2020,3862,3599,3771,91
2020, North Dakota,Cavalier County,38019,2020,3704,3504,3659,45
2010, North Dakota,Sargent County,38081,2010,3829,3753,3778,51
2010, North Dakota,Mercer County,38057,2010,8424,8052,8303,121
2000, North Dakota,Sargent County,38081,2000,4366,4289,4334,32
2010, North Dakota,Divide County,38023,2010,2071,2030,2041,30
2000, North Dakota,Divide County,38023,2000,2283,2260,2269,14
2000, North Dakota,McLean County,38055,2000,9311,8615,9230,81
2020, North Dakota,McLean County,38055,2020,9771,8405,9623,148
2010, North Dakota,McLean County,38055,2010,8962,8158,8851,111
2000, North Dakota,Mercer County,38057,2000,8644,8302,8612,32
2020, North Dakota,Divide County,38023,2020,2195,2054,2142,53
2010, North Dakota,Oliver County,38065,2010,1846,1796,1827,19
2000, North Dakota,Cavalier County,38019,2000,4831,4739,4800,31
2020, North Dakota,Oliver County,38065,2020,1877,1757,1849,28
2000, North Dakota,Emmons County,38029,2000,4331,4290,4281,50
2000, North Dakota,Stark County,38089,2000,22636,22074,22400,236
2000, North Dakota,Renville County,38075,2000,2610,2551,2591,19
2020, North Dakota,Emmons County,38029,2020,3301,3179,3266,35
2010, North Dakota,Stark County,38089,2010,24199,23026,23745,454
2010, North Dakota,Renville County,38075,2010,2470,2419,2446,24
2020, North Dakota,Renville County,38075,2020,2282,2161,2245,37
2010, North Dakota,Emmons County,38029,2010,3550,3495,3516,34
2010, North Dakota,Eddy County,38027,2010,2385,2270,2333,52
2020, North Dakota,Ransom County,38073,2020,5703,5400,5574,129
2000, North Dakota,Eddy County,38027,2000,2757,2657,2740,17
2020, North Dakota,Eddy County,38027,2020,2347,2109,2270,77
2010, North Dakota,Ransom County,38073,2010,5457,5338,5391,66
2000, North Dakota,Oliver County,38065,2000,2065,2015,2052,13
2000, North Dakota,Steele County,38091,2000,2258,2220,2254,4
2000, North Dakota,Barnes County,38003,2000,11775,11529,11711,64
2020, North Dakota,Steele County,38091,2020,1798,1732,1762,36
2010, North Dakota,Steele County,38091,2010,1975,1927,1955,20
2020, North Dakota,Adams County,38001,2020,2200,2039,2164,36
2010, North Dakota,Walsh County,38099,2010,11119,10391,10150,969
2020, North Dakota,Walsh County,38099,2020,10563,9085,9247,1316
2010, Ohio,Noble County,39121,2010,14645,14072,14593,52
2020, Ohio,Athens County,39009,2020,62431,54513,60981,1450
2010, Ohio,Williams County,39171,2010,37642,36117,36252,1390
2000, Ohio,Perry County,39127,2000,34078,33581,33926,152
2020, Ohio,Perry County,39127,2020,35408,33710,35156,252
2000, Ohio,Noble County,39121,2000,14058,13010,13998,60
2020, Ohio,Auglaize County,39011,2020,46422,43929,45641,781
2000, Ohio,Clermont County,39025,2000,177977,172866,176430,1547
2010, Ohio,Clermont County,39025,2010,197363,189250,194467,2896
2010, Ohio,Auglaize County,39011,2010,45949,44959,45406,543
2010, Ohio,Perry County,39127,2010,36058,35290,35863,195
2000, Ohio,Auglaize County,39011,2000,46611,45735,46301,310
2020, Ohio,Pike County,39131,2020,27088,25559,26869,219
2010, Ohio,Portage County,39133,2010,161419,148936,159346,2073
2020, Ohio,Clermont County,39025,2020,208601,189024,203645,4956
2020, Ohio,Pickaway County,39129,2020,58539,52734,57636,903
2010, Ohio,Pickaway County,39129,2010,55698,52655,55110,588
2020, Ohio,Wood County,39173,2020,132248,115339,123968,8280
2000, Ohio,Pickaway County,39129,2000,52727,48482,52394,333
2010, Ohio,Champaign County,39021,2010,40097,37986,39646,451
2000, Ohio,Pike County,39131,2000,27695,26786,27540,155
2000, Ohio,Portage County,39133,2000,152061,143545,150968,1093
2000, Ohio,Williams County,39171,2000,39188,37821,38139,1049
2000, Ohio,Wood County,39173,2000,121065,114802,117032,4033
2020, Ohio,Portage County,39133,2020,161791,139778,158286,3505
2010, Ohio,Pike County,39131,2010,28709,27729,28502,207
2020, Ohio,Champaign County,39021,2020,38714,35615,38066,648
2020, Ohio,Williams County,39171,2020,37102,34164,35240,1862
2000, Ohio,Ashland County,39005,2000,52523,51231,52184,339
2020, Ohio,Ashtabula County,39007,2020,97574,85486,93085,4489
2010, Ohio,Wood County,39173,2010,125488,116422,119825,5663
2020, Ohio,Ashland County,39005,2020,52447,49249,51585,862
2010, Ohio,Ashland County,39005,2010,53139,51692,52638,501
2000, Ohio,Champaign County,39021,2000,38890,37230,38621,269
2010, Ohio,Athens County,39009,2010,64757,59448,63755,1002
2000, Ohio,Belmont County,39013,2000,70226,66698,69952,274
2000, Ohio,Richland County,39139,2000,128852,113600,127652,1200
2020, Ohio,Wyandot County,39175,2020,21900,20732,21259,641
2020, Ohio,Noble County,39121,2020,14115,12886,13942,173
2010, Ohio,Butler County,39017,2010,368130,316667,353460,14670
2000, Ohio,Butler County,39017,2000,332807,303510,328036,4771
2020, Ohio,Butler County,39017,2020,390357,299100,365092,25265
2010, Ohio,Ross County,39141,2010,78064,70835,77316,748
2000, Ohio,Ross County,39141,2000,73345,67288,72916,429
2020, Ohio,Ross County,39141,2020,77093,68104,76062,1031
2000, Ohio,Paulding County,39125,2000,20293,19451,19681,612
2020, Ohio,Ottawa County,39123,2020,40364,37275,38305,2059
2010, Ohio,Ottawa County,39123,2010,41428,39968,39673,1755
2020, Ohio,Wayne County,39169,2020,116894,107729,114139,2755
2010, Ohio,Wayne County,39169,2010,114520,109543,112720,1800
2000, Ohio,Wayne County,39169,2000,111564,107677,110727,837
2000, Ohio,Carroll County,39019,2000,28836,28316,28678,158
2010, Ohio,Ashtabula County,39007,2010,101497,94041,98056,3441
2000, Ohio,Ashtabula County,39007,2000,102728,96635,100436,2292
2010, Ohio,Carroll County,39019,2010,28836,28202,28598,238
2020, Ohio,Carroll County,39019,2020,26721,25307,26422,299
2000, Ohio,Ottawa County,39123,2000,40985,39576,39450,1535
2020, Ohio,Belmont County,39013,2020,66497,60831,65673,824
2010, Ohio,Paulding County,39125,2010,19614,18767,18776,838
2000, Ohio,Wyandot County,39175,2000,22908,22429,22574,334
2020, Ohio,Brown County,39015,2020,43676,41237,43189,487
2010, Ohio,Brown County,39015,2010,44846,43736,44577,269
2000, Ohio,Brown County,39015,2000,42285,41474,42100,185
2010, Ohio,Belmont County,39013,2010,70400,66206,69971,429
2000, Ohio,Muskingum County,39119,2000,84585,79438,84149,436
2020, Ohio,Muskingum County,39119,2020,86410,77309,85355,1055
2010, Ohio,Muskingum County,39119,2010,86074,80020,85424,650
2010, Ohio,Richland County,39139,2010,124475,108870,122743,1732
2000, Ohio,Athens County,39009,2000,62223,58166,61584,639
2020, Ohio,Paulding County,39125,2020,18806,17255,17796,1010
2020, Ohio,Richland County,39139,2020,124936,105139,122321,2615
2000, Ohio,Washington County,39167,2000,63251,61563,62927,324
2010, Ohio,Washington County,39167,2010,61778,59599,61317,461
2020, Ohio,Clark County,39023,2020,136001,111088,130688,5313
2000, Ohio,Clark County,39023,2000,144742,127541,143043,1699
2010, Ohio,Clark County,39023,2010,138333,119440,134528,3805
2010, Ohio,Preble County,39135,2010,42270,41242,42016,254
2020, Ohio,Preble County,39135,2020,40999,38857,40613,386
2000, Ohio,Preble County,39135,2000,42337,41691,42156,181
2010, Ohio,Wyandot County,39175,2010,22615,21924,22111,504
2020, Ohio,Washington County,39167,2020,59771,55950,59054,717
2000, Ohio,Morrow County,39117,2000,31628,31111,31445,183
2020, Ohio,Miami County,39109,2020,108774,97622,106575,2199
2010, Ohio,Morrow County,39117,2010,34827,34025,34447,380
2000, Ohio,Logan County,39091,2000,46005,44233,45673,332
2020, Ohio,Sandusky County,39143,2020,58896,50425,52841,6055
2020, Ohio,Lorain County,39093,2020,312964,247300,280047,32917
2020, Ohio,Cuyahoga County,39035,2020,1264817,736116,1181490,83327
2000, Ohio,Cuyahoga County,39035,2000,1393978,938863,1346900,47078
2010, Ohio,Lorain County,39093,2010,301356,255410,276066,25290
2000, Ohio,Lorain County,39093,2000,284664,243514,264988,19676
2010, Ohio,Cuyahoga County,39035,2010,1280122,814103,1218852,61270
2000, Ohio,Sandusky County,39143,2000,61792,56974,57494,4298
2010, Ohio,Sandusky County,39143,2010,60944,55579,55509,5435
2020, Ohio,Darke County,39037,2020,51881,49322,51022,859
2010, Ohio,Darke County,39037,2010,52959,51783,52313,646
2010, Ohio,Logan County,39091,2010,45858,43722,45319,539
2000, Ohio,Darke County,39037,2000,53309,52290,52852,457
2010, Ohio,Lucas County,39095,2010,441815,326868,414841,26974
2020, Ohio,Lucas County,39095,2020,431279,295109,399112,32167
2010, Ohio,Geauga County,39055,2010,93389,90514,92388,1001
2020, Ohio,Geauga County,39055,2020,95397,89422,93733,1664
2000, Ohio,Geauga County,39055,2000,90895,88553,90357,538
2000, Ohio,Defiance County,39039,2000,39500,36575,36643,2857
2010, Ohio,Miami County,39109,2010,102506,96722,101165,1341
2000, Ohio,Miami County,39109,2000,98868,94694,98147,721
2010, Ohio,Defiance County,39039,2010,39037,36208,35628,3409
2020, Ohio,Defiance County,39039,2020,38286,33648,34336,3950
2020, Ohio,Delaware County,39041,2020,214124,173231,207112,7012
2010, Ohio,Delaware County,39041,2010,174214,156328,170545,3669
2000, Ohio,Lucas County,39095,2000,455054,352678,434384,20670
2020, Ohio,Logan County,39091,2020,46150,42049,45146,1004
2000, Ohio,Shelby County,39149,2000,47910,46011,47527,383
2010, Ohio,Shelby County,39149,2010,49423,46793,48762,661
2010, Ohio,Allen County,39003,2010,106331,89089,103818,2513
2000, Ohio,Allen County,39003,2000,108473,92147,106928,1545
2000, Ohio,Hardin County,39065,2000,31945,31159,31697,248
2020, Ohio,Hardin County,39065,2020,30696,28650,29999,697
2020, Ohio,Monroe County,39111,2020,13385,12945,13318,67
2010, Ohio,Monroe County,39111,2010,14642,14358,14583,59
2000, Ohio,Monroe County,39111,2000,15180,14986,15118,62
2010, Ohio,Hardin County,39065,2010,32058,30990,31651,407
2020, Ohio,Hancock County,39063,2020,74920,66590,70722,4198
2010, Ohio,Hancock County,39063,2010,74782,69828,71419,3363
2020, Ohio,Crawford County,39033,2020,42025,39652,41387,638
2010, Ohio,Crawford County,39033,2010,43784,42556,43251,533
2000, Ohio,Crawford County,39033,2000,46966,46022,46605,361
2000, Ohio,Hancock County,39063,2000,71295,67832,69108,2187
2010, Ohio,Hamilton County,39061,2010,802374,552330,781767,20607
2000, Ohio,Hamilton County,39061,2000,845303,616487,835789,9514
2020, Ohio,Hamilton County,39061,2020,830639,525850,794389,36250
2020, Ohio,Licking County,39089,2020,178519,154070,174531,3988
2000, Ohio,Licking County,39089,2000,145491,139147,144384,1107
2010, Ohio,Licking County,39089,2010,166492,155190,164180,2312
2010, Ohio,Guernsey County,39059,2010,40087,38486,39738,349
2000, Ohio,Guernsey County,39059,2000,40792,39275,40538,254
2020, Ohio,Guernsey County,39059,2020,38438,35898,37994,444
2020, Ohio,Greene County,39057,2020,167966,137146,162750,5216
2020, Ohio,Allen County,39003,2020,102206,80753,98934,3272
2010, Ohio,Greene County,39057,2010,161573,139670,158134,3439
2020, Ohio,Shelby County,39149,2020,48230,44280,47443,787
2000, Ohio,Delaware County,39041,2000,109989,103663,108880,1109
2020, Ohio,Harrison County,39067,2020,14483,13456,14353,130
2000, Ohio,Gallia County,39053,2000,31069,29596,30878,191
2020, Ohio,Gallia County,39053,2020,29220,27049,28958,262
2010, Ohio,Medina County,39103,2010,172332,165642,169585,2747
2000, Ohio,Medina County,39103,2000,151095,146956,149696,1399
2020, Ohio,Medina County,39103,2020,182470,167082,177878,4592
2000, Ohio,Tuscarawas County,39157,2000,90914,88976,90264,650
2000, Ohio,Marion County,39101,2000,66217,60987,65494,723
2020, Ohio,Marion County,39101,2020,65359,56754,63403,1956
2010, Ohio,Marion County,39101,2010,66501,60565,64998,1503
2010, Ohio,Fayette County,39047,2010,29030,27471,28510,520
2010, Ohio,Putnam County,39137,2010,34499,33012,32609,1890
2020, Ohio,Putnam County,39137,2020,34451,32077,32222,2229
2020, Ohio,Fayette County,39047,2020,28951,26523,28270,681
2000, Ohio,Fayette County,39047,2000,28433,27182,28081,352
2010, Ohio,Tuscarawas County,39157,2010,92582,89393,90815,1767
2000, Ohio,Scioto County,39145,2000,79195,75139,78718,477
2020, Ohio,Fairfield County,39045,2020,158921,131676,154900,4021
2000, Ohio,Fairfield County,39045,2000,122759,116803,121766,993
2010, Ohio,Union County,39159,2010,52300,48587,51639,661
2000, Ohio,Union County,39159,2000,40909,38965,40600,309
2020, Ohio,Union County,39159,2020,62784,53670,61250,1534
2000, Ohio,Erie County,39043,2000,79551,70514,77887,1664
2010, Ohio,Erie County,39043,2010,77079,67066,74475,2604
2020, Ohio,Erie County,39043,2020,75622,62122,72492,3130
2010, Ohio,Scioto County,39145,2010,79499,75045,78611,888
2000, Ohio,Van Wert County,39161,2000,29659,28896,29197,462
2010, Ohio,Van Wert County,39161,2010,28744,27762,28004,740
2020, Ohio,Scioto County,39145,2020,74008,67925,72956,1052
2010, Ohio,Fairfield County,39045,2010,146156,131830,143646,2510
2020, Ohio,Tuscarawas County,39157,2020,93263,85679,89301,3962
2020, Ohio,Meigs County,39105,2020,22210,21250,22038,172
2000, Ohio,Meigs County,39105,2000,23072,22548,22934,138
2010, Ohio,Fulton County,39051,2010,42698,40538,39357,3341
2020, Ohio,Fulton County,39051,2020,42713,38092,38922,3791
2000, Ohio,Fulton County,39051,2000,42084,40254,39662,2422
2010, Ohio,Madison County,39097,2010,43435,39364,42813,622
2020, Ohio,Madison County,39097,2020,43824,38046,42561,1263
2000, Ohio,Madison County,39097,2000,40213,36896,39919,294
2010, Ohio,Trumbull County,39155,2010,210312,187113,207511,2801
2020, Ohio,Trumbull County,39155,2020,201977,171062,197798,4179
2000, Ohio,Trumbull County,39155,2000,225116,203084,223322,1794
2020, Ohio,Mahoning County,39099,2020,228614,172721,214521,14093
2000, Ohio,Mahoning County,39099,2000,257555,208727,249915,7640
2010, Ohio,Mahoning County,39099,2010,238823,190848,227687,11136
2000, Ohio,Mercer County,39107,2000,40924,40286,40454,470
2010, Ohio,Mercer County,39107,2010,40814,39761,40200,614
2020, Ohio,Mercer County,39107,2020,42528,40057,41600,928
2020, Ohio,Morrow County,39117,2020,34950,32933,34370,580
2000, Ohio,Vinton County,39163,2000,12806,12560,12746,60
2020, Ohio,Vinton County,39163,2020,12800,12258,12716,84
2010, Ohio,Vinton County,39163,2010,13435,13157,13364,71
2020, Ohio,Seneca County,39147,2020,55069,49358,52170,2899
2000, Ohio,Seneca County,39147,2000,58683,55770,56711,1972
2020, Ohio,Franklin County,39049,2020,1323807,802685,1232625,91182
2000, Ohio,Franklin County,39049,2000,1068978,806851,1044699,24279
2010, Ohio,Franklin County,39049,2010,1163414,805617,1107696,55718
2010, Ohio,Seneca County,39147,2010,56745,53183,54221,2524
2000, Ohio,Putnam County,39137,2000,34726,33426,33205,1521
2010, Ohio,Meigs County,39105,2010,23770,23150,23655,115
2010, Ohio,Gallia County,39053,2010,30934,29308,30659,275
2010, Ohio,Harrison County,39067,2010,15864,15216,15785,79
2000, Ohio,Greene County,39057,2000,147886,131975,146073,1813
2020, Ohio,Van Wert County,39161,2020,28931,26833,27834,1097
2020, Ohio,Jefferson County,39081,2020,65249,56954,64090,1159
2000, Ohio,Montgomery County,39113,2000,559062,428084,551966,7096
2020, Ohio,Montgomery County,39113,2020,537309,365077,516130,21179
2010, Ohio,Montgomery County,39113,2010,535153,395272,522976,12177
2010, Ohio,Morgan County,39115,2010,15054,14030,14957,97
2000, Ohio,Morgan County,39115,2000,14897,13952,14836,61
2020, Ohio,Morgan County,39115,2020,13802,12568,13675,127
2010, Ohio,Holmes County,39075,2010,42366,41826,42037,329
2020, Ohio,Holmes County,39075,2020,44223,43088,43749,474
2010, Ohio,Jackson County,39079,2010,33225,32267,32960,265
2020, Ohio,Hocking County,39073,2020,28050,26595,27818,232
2010, Ohio,Hocking County,39073,2010,29380,28639,29182,198
2000, Ohio,Hocking County,39073,2000,28241,27547,28117,124
2020, Ohio,Clinton County,39027,2020,42018,38484,41253,765
2010, Ohio,Clinton County,39027,2010,42040,39805,41481,559
2000, Ohio,Clinton County,39027,2000,40543,38917,40277,266
2000, Ohio,Adams County,39001,2000,27330,26721,27155,175
2010, Ohio,Jefferson County,39081,2010,69709,64077,68936,773
2010, Ohio,Warren County,39165,2010,212693,192431,207909,4784
2010, Ohio,Adams County,39001,2010,28550,27882,28307,243
2000, Ohio,Knox County,39083,2000,54500,53226,54129,371
2000, Ohio,Jackson County,39079,2000,32641,31953,32444,197
2020, Ohio,Jackson County,39079,2020,32653,30956,32347,306
2010, Ohio,Huron County,39077,2010,59626,56556,56293,3333
2000, Ohio,Huron County,39077,2000,59487,57094,57370,2117
2020, Ohio,Huron County,39077,2020,58565,52412,54481,4084
2020, Ohio,Stark County,39151,2020,374853,313356,364337,10516
2010, Ohio,Stark County,39151,2010,375586,333191,369621,5965
2000, Ohio,Harrison County,39067,2000,15856,15300,15797,59
2010, Ohio,Columbiana County,39029,2010,107841,102959,106493,1348
2000, Ohio,Columbiana County,39029,2000,112075,108071,110766,1309
2020, Ohio,Columbiana County,39029,2020,101877,94155,100125,1752
2020, Ohio,Lake County,39085,2020,232603,199296,221241,11362
2000, Ohio,Lake County,39085,2000,227511,217041,223632,3879
2010, Ohio,Lake County,39085,2010,230041,212713,222216,7825
2000, Ohio,Stark County,39151,2000,378098,341342,374606,3492
2020, Ohio,Knox County,39083,2020,62721,58400,61525,1196
2010, Ohio,Knox County,39083,2010,60921,58933,60184,737
2000, Ohio,Jefferson County,39081,2000,73894,68341,73435,459
2000, Ohio,Warren County,39165,2000,158383,149919,156750,1633
2000, Ohio,Holmes County,39075,2000,38943,38564,38651,292
2010, Ohio,Summit County,39153,2010,541781,436487,533121,8660
2000, Ohio,Summit County,39153,2000,542899,453336,538118,4781
2000, Ohio,Coshocton County,39031,2000,36655,35685,36439,216
2000, Ohio,Henry County,39069,2000,29210,27845,27634,1576
2020, Ohio,Henry County,39069,2020,27662,25244,25475,2187
2010, Ohio,Henry County,39069,2010,28215,26857,26355,1860
2020, Ohio,Warren County,39165,2020,242337,200073,234599,7738
2000, Ohio,Lawrence County,39087,2000,62319,60169,61964,355
2010, Ohio,Lawrence County,39087,2010,62450,59864,62005,445
2020, Ohio,Summit County,39153,2020,540428,400818,527222,13206
2020, Ohio,Highland County,39071,2020,43317,40662,42893,424
2020, Ohio,Lawrence County,39087,2020,58240,54258,57622,618
2010, Ohio,Highland County,39071,2010,43589,42042,43270,319
2000, Ohio,Highland County,39071,2000,40875,39599,40659,216
2010, Ohio,Coshocton County,39031,2010,36901,35810,36622,279
2020, Ohio,Coshocton County,39031,2020,36612,34730,36211,401
2020, Ohio,Adams County,39001,2020,27477,26277,27260,217
2010, Oklahoma,McClain County,40087,2010,34506,29168,32106,2400
2000, Oklahoma,Tulsa County,40143,2000,563299,422581,529683,33616
2020, Oklahoma,Ottawa County,40115,2020,30285,19365,28577,1708
2010, Oklahoma,Ottawa County,40115,2010,31848,21969,30349,1499
2000, Oklahoma,Ottawa County,40115,2000,33194,24612,32133,1061
2000, Oklahoma,Carter County,40019,2000,45621,35550,44352,1269
2020, Oklahoma,Jackson County,40065,2020,24785,16532,18848,5937
2010, Oklahoma,Carter County,40019,2010,47557,35380,45029,2528
2000, Oklahoma,Pontotoc County,40123,2000,35143,26638,34335,808
2020, Oklahoma,Sequoyah County,40135,2020,39281,22928,37555,1726
2010, Oklahoma,Jackson County,40065,2010,26446,19255,20908,5538
2000, Oklahoma,Sequoyah County,40135,2000,38972,26548,38179,793
2010, Oklahoma,Sequoyah County,40135,2010,42391,28204,40953,1438
2020, Oklahoma,Kay County,40071,2020,43700,31801,40048,3652
2000, Oklahoma,Kay County,40071,2000,48080,40463,46035,2045
2010, Oklahoma,Kay County,40071,2010,46562,37332,43570,2992
2010, Oklahoma,Major County,40093,2010,7527,6846,6962,565
2000, Oklahoma,Jackson County,40065,2000,28439,21654,23993,4446
2020, Oklahoma,Mayes County,40097,2020,39046,23933,37671,1375
2010, Oklahoma,Stephens County,40137,2010,45048,38328,42258,2790
2020, Oklahoma,Stephens County,40137,2020,42848,33461,39396,3452
2000, Oklahoma,Major County,40093,2000,7545,7165,7242,303
2000, Oklahoma,Mayes County,40097,2000,38369,27679,37651,718
2000, Oklahoma,McClain County,40087,2000,27740,24207,26391,1349
2010, Oklahoma,Pontotoc County,40123,2010,37492,26687,35969,1523
2020, Oklahoma,Pontotoc County,40123,2020,38065,23271,35857,2208
2020, Oklahoma,McClain County,40087,2020,41662,31626,37963,3699
2020, Oklahoma,Major County,40093,2020,7782,6622,6998,784
2010, Oklahoma,Mayes County,40097,2010,41259,28044,40162,1097
2010, Oklahoma,Johnston County,40069,2010,10957,8015,10534,423
2010, Oklahoma,Seminole County,40133,2010,25482,17450,24579,903
2010, Oklahoma,Osage County,40113,2010,47472,31327,46106,1366
2000, Oklahoma,Alfalfa County,40003,2000,6105,5459,5928,177
2010, Oklahoma,Kiowa County,40075,2010,9446,7573,8614,832
2000, Oklahoma,Atoka County,40005,2000,13879,10528,13683,196
2000, Oklahoma,Kingfisher County,40073,2000,13926,12267,12965,961
2010, Oklahoma,Marshall County,40095,2010,15840,11690,13628,2212
2020, Oklahoma,Marshall County,40095,2020,15312,10210,12707,2605
2020, Oklahoma,Osage County,40113,2020,45818,27903,43946,1872
2000, Oklahoma,Marshall County,40095,2000,13184,10282,12050,1134
2010, Oklahoma,Alfalfa County,40003,2010,5642,5042,5418,224
2000, Oklahoma,Adair County,40001,2000,21038,10207,20381,657
2020, Oklahoma,Alfalfa County,40003,2020,5699,4771,5420,279
2010, Oklahoma,Kingfisher County,40073,2010,15034,12707,13012,2022
2010, Oklahoma,Adair County,40001,2010,22683,9757,21486,1197
2020, Oklahoma,Kingfisher County,40073,2020,15184,11652,12429,2755
2020, Oklahoma,Johnston County,40069,2020,10272,6892,9691,581
2000, Oklahoma,Kiowa County,40075,2000,10227,8544,9538,689
2000, Oklahoma,Seminole County,40133,2000,24894,17610,24342,552
2010, Oklahoma,Atoka County,40005,2010,14182,10460,13773,409
2000, Oklahoma,Ellis County,40045,2000,4075,3924,3969,106
2000, Oklahoma,Johnston County,40069,2000,10513,7999,10253,260
2000, Oklahoma,Jefferson County,40067,2000,6818,5941,6340,478
2020, Oklahoma,Jefferson County,40067,2020,5337,4206,4753,584
2020, Oklahoma,Seminole County,40133,2020,23556,14438,22380,1176
2010, Oklahoma,Jefferson County,40067,2010,6472,5461,5920,552
2020, Oklahoma,Pottawatomie County,40125,2020,72454,50484,68166,4288
2000, Oklahoma,Pottawatomie County,40125,2000,65521,52336,63977,1544
2000, Oklahoma,Osage County,40113,2000,44437,29779,43497,940
2010, Oklahoma,Pottawatomie County,40125,2010,69442,52969,66564,2878
2020, Oklahoma,Atoka County,40005,2020,14143,9480,13595,548
2020, Oklahoma,Adair County,40001,2020,19495,7645,18243,1252
2020, Oklahoma,Kiowa County,40075,2020,8509,6519,7556,953
2020, Oklahoma,Ellis County,40045,2020,3749,3269,3409,340
2010, Oklahoma,Canadian County,40017,2010,115541,96058,107747,7794
2020, Oklahoma,Canadian County,40017,2020,154405,112548,138028,16377
2000, Oklahoma,Canadian County,40017,2000,87697,76301,84311,3386
2010, Oklahoma,Ellis County,40045,2010,4151,3920,3900,251
2020, Oklahoma,Tulsa County,40143,2020,669279,390702,569230,100049
2020, Oklahoma,Haskell County,40061,2020,11561,7855,11032,529
2000, Oklahoma,Caddo County,40015,2000,30150,19763,28256,1894
2020, Oklahoma,Texas County,40139,2020,21384,10136,10561,10823
2020, Oklahoma,Bryan County,40013,2020,46067,31023,42639,3428
2000, Oklahoma,Bryan County,40013,2000,36534,29236,35567,967
2010, Oklahoma,Bryan County,40013,2010,42416,32316,40309,2107
2020, Oklahoma,Carter County,40019,2020,48003,32121,44381,3622
2000, Oklahoma,Latimer County,40077,2000,10692,7806,10528,164
2010, Oklahoma,Latimer County,40077,2010,11154,7825,10861,293
2020, Oklahoma,Tillman County,40141,2020,6968,4554,5045,1923
2000, Oklahoma,Tillman County,40141,2000,9287,6892,7646,1641
2010, Oklahoma,Tillman County,40141,2010,7992,5876,6209,1783
2000, Oklahoma,Grant County,40053,2000,5144,4903,5049,95
2020, Oklahoma,Latimer County,40077,2020,9444,5925,9100,344
2000, Oklahoma,Logan County,40083,2000,33924,27676,32937,987
2010, Oklahoma,Logan County,40083,2010,41848,33886,39678,2170
2020, Oklahoma,Logan County,40083,2020,49555,37097,45552,4003
2020, Oklahoma,Grant County,40053,2020,4169,3701,3985,184
2010, Oklahoma,Grant County,40053,2010,4527,4210,4369,158
2010, Oklahoma,Texas County,40139,2010,20640,15617,11981,8659
2000, Oklahoma,Texas County,40139,2000,20107,15429,14104,6003
2020, Oklahoma,Greer County,40055,2020,5491,4277,4826,665
2000, Oklahoma,Greer County,40055,2000,6061,4937,5610,451
2010, Oklahoma,Haskell County,40061,2010,12769,9560,12343,426
2000, Oklahoma,Harper County,40059,2000,3562,3415,3361,201
2020, Oklahoma,Harper County,40059,2020,3272,2488,2539,733
2010, Oklahoma,Harper County,40059,2010,3685,3219,3040,645
2020, Oklahoma,Harmon County,40057,2020,2488,1742,1748,740
2010, Oklahoma,Harmon County,40057,2010,2922,2138,2166,756
2000, Oklahoma,Haskell County,40061,2000,11792,9226,11615,177
2010, Oklahoma,Le Flore County,40079,2010,50384,37827,46930,3454
2010, Oklahoma,Payne County,40119,2010,77350,63353,74360,2990
2000, Oklahoma,Harmon County,40057,2000,3283,2385,2535,748
2000, Oklahoma,Le Flore County,40079,2000,48109,38657,46260,1849
2020, Oklahoma,Blaine County,40011,2020,8735,6463,7750,985
2010, Oklahoma,Blaine County,40011,2010,11943,9518,9070,2873
2000, Oklahoma,Blaine County,40011,2000,11976,9136,11183,793
2010, Oklahoma,Greer County,40055,2010,6239,5181,5630,609
2000, Oklahoma,Lincoln County,40081,2000,32080,27726,31597,483
2020, Oklahoma,Lincoln County,40081,2020,33458,26543,32321,1137
2010, Oklahoma,Lincoln County,40081,2010,34273,29426,33435,838
2020, Oklahoma,Le Flore County,40079,2020,48129,32654,44556,3573
2000, Oklahoma,Payne County,40119,2000,68190,57508,66727,1463
2020, Oklahoma,Payne County,40119,2020,81646,60654,76273,5373
2000, Oklahoma,Pittsburg County,40121,2000,43953,33932,43014,939
2000, Oklahoma,Woodward County,40153,2000,18486,17050,17590,896
2000, Oklahoma,Beckham County,40009,2000,19799,17236,18720,1079
2020, Oklahoma,Garvin County,40049,2020,25656,18904,23204,2452
2010, Oklahoma,Beckham County,40009,2010,22119,18805,19500,2619
2020, Oklahoma,Beckham County,40009,2020,22410,17519,19726,2684
2010, Oklahoma,Garvin County,40049,2010,27576,22462,25863,1713
2000, Oklahoma,Garfield County,40047,2000,57813,51253,55426,2387
2010, Oklahoma,Garfield County,40047,2010,60580,50807,55227,5353
2020, Oklahoma,Woodward County,40153,2020,20470,16136,17464,3006
2020, Oklahoma,Garfield County,40047,2020,62846,45297,53864,8982
2020, Oklahoma,Beaver County,40007,2020,5049,3811,3745,1304
2000, Oklahoma,Beaver County,40007,2000,5857,5430,5227,630
2020, Oklahoma,Hughes County,40063,2020,13367,8227,12612,755
2010, Oklahoma,Hughes County,40063,2010,14003,9543,13473,530
2000, Oklahoma,Hughes County,40063,2000,14154,10300,13801,353
2000, Oklahoma,Stephens County,40137,2000,43182,38158,41473,1709
2020, Oklahoma,Caddo County,40015,2020,26945,16743,22610,4335
2010, Oklahoma,Caddo County,40015,2010,29600,18668,26605,2995
2010, Oklahoma,Beaver County,40007,2010,5636,4664,4501,1135
2010, Oklahoma,Tulsa County,40143,2010,603403,417413,536821,66582
2020, Oklahoma,Rogers County,40131,2020,95240,63792,89983,5257
2000, Oklahoma,Rogers County,40131,2000,70641,56427,69347,1294
2010, Oklahoma,Pittsburg County,40121,2010,45837,33745,44051,1786
2010, Oklahoma,Pawnee County,40117,2010,16577,13363,16241,336
2020, Oklahoma,Pawnee County,40117,2020,15553,11702,15086,467
2000, Oklahoma,Pawnee County,40117,2000,16612,13667,16420,192
2020, Oklahoma,Love County,40085,2020,10146,7206,8461,1685
2000, Oklahoma,Love County,40085,2000,8831,7431,8212,619
2010, Oklahoma,Love County,40085,2010,9423,7426,8310,1113
2020, Oklahoma,Grady County,40051,2020,54795,43117,51275,3520
2010, Oklahoma,Rogers County,40131,2010,86905,65415,83676,3229
2010, Oklahoma,Grady County,40051,2010,52431,44994,50026,2405
2020, Oklahoma,Pittsburg County,40121,2020,43773,29042,41507,2266
2010, Oklahoma,Woods County,40151,2010,8878,7850,8454,424
2000, Oklahoma,Woods County,40151,2000,9089,8490,8869,220
2020, Oklahoma,Woods County,40151,2020,8624,7191,8011,613
2010, Oklahoma,Woodward County,40153,2010,20081,17419,17953,2128
2020, Oklahoma,Roger Mills County,40129,2020,3442,2945,3186,256
2010, Oklahoma,Roger Mills County,40129,2010,3647,3276,3482,165
2000, Oklahoma,Roger Mills County,40129,2000,3436,3153,3345,91
2000, Oklahoma,Grady County,40051,2000,45516,39742,44200,1316
2000, Oklahoma,Garvin County,40049,2000,27210,23109,26286,924
2010, Oklahoma,Custer County,40039,2010,27469,21456,23639,3830
2000, Oklahoma,McCurtain County,40089,2000,34402,24267,33338,1064
2020, Oklahoma,Choctaw County,40023,2020,14204,8284,13609,595
2000, Oklahoma,Choctaw County,40023,2000,15342,10517,15096,246
2010, Oklahoma,Choctaw County,40023,2010,15205,9866,14778,427
2010, Oklahoma,Craig County,40035,2010,15029,10017,14659,370
2020, Oklahoma,Craig County,40035,2020,14107,8581,13680,427
2000, Oklahoma,Craig County,40035,2000,14950,10246,14771,179
2020, Oklahoma,Cotton County,40033,2020,5527,4212,5166,361
2010, Oklahoma,Cotton County,40033,2010,6193,5035,5849,344
2000, Oklahoma,Cotton County,40033,2000,6614,5602,6293,321
2000, Oklahoma,Cimarron County,40025,2000,3148,2700,2663,485
2020, Oklahoma,Cimarron County,40025,2020,2296,1801,1733,563
2010, Oklahoma,Cimarron County,40025,2010,2475,2097,1961,514
2000, Oklahoma,Washington County,40147,2000,48996,39771,47703,1293
2020, Oklahoma,Delaware County,40041,2020,40397,25394,38776,1621
2010, Oklahoma,Pushmataha County,40127,2010,11572,8675,11292,280
2020, Oklahoma,Comanche County,40031,2020,121125,69301,104480,16645
2000, Oklahoma,Comanche County,40031,2000,114996,74988,105321,9675
2010, Oklahoma,Comanche County,40031,2010,124098,79996,110202,13896
2020, Oklahoma,Washington County,40147,2020,52455,36126,49095,3360
2010, Oklahoma,Washington County,40147,2010,50976,39929,48420,2556
2020, Oklahoma,Muskogee County,40101,2020,66339,35802,61840,4499
2020, Oklahoma,Creek County,40037,2020,71754,52436,68342,3412
2000, Oklahoma,Muskogee County,40101,2000,69451,44261,67594,1857
2010, Oklahoma,Creek County,40037,2010,69967,55764,67815,2152
2010, Oklahoma,McCurtain County,40089,2010,33151,22259,31599,1552
2010, Oklahoma,Delaware County,40041,2010,41487,27811,40239,1248
2000, Oklahoma,Wagoner County,40145,2000,57491,46032,56054,1437
2010, Oklahoma,Wagoner County,40145,2010,73085,55340,69597,3488
2020, Oklahoma,Wagoner County,40145,2020,80981,54125,74844,6137
2010, Oklahoma,Nowata County,40105,2010,10536,7267,10296,240
2020, Oklahoma,Nowata County,40105,2020,9320,5900,9079,241
2000, Oklahoma,Nowata County,40105,2000,10569,7655,10439,130
2020, Oklahoma,Noble County,40103,2020,10924,8560,10504,420
2000, Oklahoma,Noble County,40103,2000,11411,9864,11206,205
2010, Oklahoma,Noble County,40103,2010,11561,9740,11261,300
2010, Oklahoma,Cherokee County,40021,2010,46987,24567,44035,2952
2020, Oklahoma,Cherokee County,40021,2020,47078,20787,43641,3437
2000, Oklahoma,Cherokee County,40021,2000,42521,23985,40761,1760
2000, Oklahoma,Custer County,40039,2000,26142,21283,23781,2361
2020, Oklahoma,Dewey County,40043,2020,4484,3827,4224,260
2010, Oklahoma,Dewey County,40043,2010,4810,4285,4579,231
2000, Oklahoma,Dewey County,40043,2000,4743,4371,4616,127
2020, Oklahoma,Custer County,40039,2020,28513,20025,23129,5384
2000, Oklahoma,Washita County,40149,2000,11508,10623,10992,516
2010, Oklahoma,Washita County,40149,2010,11629,10263,10685,944
2020, Oklahoma,Washita County,40149,2020,10924,9161,9944,980
2000, Oklahoma,Creek County,40037,2000,67367,55425,66084,1283
2010, Oklahoma,Muskogee County,40101,2010,70990,42467,67302,3688
2000, Oklahoma,Delaware County,40041,2000,37077,26037,36428,649
2000, Oklahoma,Murray County,40099,2000,12623,10194,12226,397
2000, Oklahoma,McIntosh County,40091,2000,19456,14123,19208,248
2010, Oklahoma,McIntosh County,40091,2010,20252,14238,19862,390
2020, Oklahoma,McIntosh County,40091,2020,18941,12810,18450,491
2020, Oklahoma,Murray County,40099,2020,13904,9668,12978,926
2010, Oklahoma,Murray County,40099,2010,13488,10515,12826,662
2020, Oklahoma,Cleveland County,40027,2020,295528,203615,265216,30312
2010, Oklahoma,Cleveland County,40027,2010,255755,202811,237863,17892
2000, Oklahoma,Cleveland County,40027,2000,208016,173909,199620,8396
2000, Oklahoma,Okfuskee County,40107,2000,11814,7734,11620,194
2020, Oklahoma,Okfuskee County,40107,2020,11310,6685,10968,342
2020, Oklahoma,Oklahoma County,40109,2020,796292,437129,642794,153498
2000, Oklahoma,Oklahoma County,40109,2000,660448,465195,603112,57336
2010, Oklahoma,Coal County,40029,2010,5925,4402,5773,152
2010, Oklahoma,Oklahoma County,40109,2010,718633,464387,610090,108543
2020, Oklahoma,Coal County,40029,2020,5266,3441,5068,198
2020, Oklahoma,McCurtain County,40089,2020,30814,18494,28920,1894
2010, Oklahoma,Okfuskee County,40107,2010,12191,7848,11835,356
2010, Oklahoma,Okmulgee County,40111,2010,40069,26366,38776,1293
2000, Oklahoma,Okmulgee County,40111,2000,39685,27674,38913,772
2020, Oklahoma,Pushmataha County,40127,2020,10812,7507,10436,376
2020, Oklahoma,Okmulgee County,40111,2020,36706,22091,34998,1708
2000, Oklahoma,Pushmataha County,40127,2000,11667,9097,11476,191
2000, Oklahoma,Coal County,40029,2000,6031,4534,5902,129
2020, Oregon,Sherman County,41055,2020,1870,1643,1751,119
2000, Oregon,Tillamook County,41057,2000,24262,22772,23018,1244
2000, Oregon,Sherman County,41055,2000,1934,1810,1840,94
2010, Oregon,Crook County,41013,2010,20978,19441,19515,1463
2020, Oregon,Multnomah County,41051,2020,815428,556202,711675,103753
2020, Oregon,Linn County,41043,2020,128610,107700,116039,12571
2000, Oregon,Linn County,41043,2000,103069,96059,98555,4514
2010, Oregon,Linn County,41043,2010,116672,105669,107545,9127
2010, Oregon,Multnomah County,41051,2010,735334,562421,655196,80138
2020, Oregon,Tillamook County,41057,2020,27390,22620,24444,2946
2000, Oregon,Crook County,41013,2000,19182,17830,18100,1082
2010, Oregon,Tillamook County,41057,2010,25250,23102,22966,2284
2000, Oregon,Grant County,41023,2000,7935,7593,7772,163
2000, Oregon,Jackson County,41029,2000,181269,166125,169143,12126
2020, Oregon,Grant County,41023,2020,7233,6523,6950,283
2010, Oregon,Gilliam County,41021,2010,1871,1781,1783,88
2020, Oregon,Gilliam County,41021,2020,1995,1770,1888,107
2000, Oregon,Gilliam County,41021,2000,1915,1853,1880,35
2020, Oregon,Wheeler County,41069,2020,1451,1271,1367,84
2010, Oregon,Wheeler County,41069,2010,1441,1332,1379,62
2000, Oregon,Wheeler County,41069,2000,1547,1444,1468,79
2020, Oregon,Wallowa County,41063,2020,7391,6673,7134,257
2010, Oregon,Wallowa County,41063,2010,7008,6731,6852,156
2000, Oregon,Wallowa County,41063,2000,7226,6973,7101,125
2000, Oregon,Morrow County,41049,2000,10995,8386,8309,2686
2020, Oregon,Morrow County,41049,2020,12186,7472,7198,4988
2010, Oregon,Morrow County,41049,2010,11173,8680,7676,3497
2010, Oregon,Josephine County,41033,2010,82713,76449,77462,5251
2020, Oregon,Josephine County,41033,2020,88090,75344,81053,7037
2000, Oregon,Lincoln County,41041,2000,44479,40292,42360,2119
2000, Oregon,Josephine County,41033,2000,75726,71103,72497,3229
2020, Oregon,Curry County,41015,2020,23446,19925,21772,1674
2010, Oregon,Curry County,41015,2010,22364,20574,21163,1201
2000, Oregon,Curry County,41015,2000,21137,19634,20376,761
2010, Oregon,Grant County,41023,2010,7445,7070,7238,207
2020, Oregon,Lincoln County,41041,2020,50395,40624,45544,4851
2010, Oregon,Klamath County,41035,2010,66380,57019,59465,6915
2000, Oregon,Multnomah County,41051,2000,660486,522825,610879,49607
2010, Oregon,Benton County,41003,2010,85579,74506,80112,5467
2010, Oregon,Lane County,41039,2010,351715,310685,325548,26167
2020, Oregon,Lane County,41039,2020,382971,309194,345191,37780
2000, Oregon,Lane County,41039,2000,322959,292728,308085,14874
2010, Oregon,Hood River County,41027,2010,22346,18568,15757,6589
2000, Oregon,Hood River County,41027,2000,20411,16099,15304,5107
2000, Oregon,Wasco County,41065,2000,23791,20599,21577,2214
2020, Oregon,Wasco County,41065,2020,26670,19821,21653,5017
2000, Oregon,Clatsop County,41007,2000,35630,33185,34033,1597
2020, Oregon,Clatsop County,41007,2020,41072,34525,37224,3848
2010, Oregon,Clatsop County,41007,2010,37039,33680,34201,2838
2000, Oregon,Lake County,41037,2000,7422,6752,7018,404
2010, Oregon,Lake County,41037,2010,7895,7130,7350,545
2020, Oregon,Lake County,41037,2020,8160,6691,7358,802
2020, Oregon,Columbia County,41009,2020,52589,45243,49519,3070
2010, Oregon,Columbia County,41009,2010,49351,45651,47364,1987
2000, Oregon,Columbia County,41009,2000,43560,41130,42467,1093
2010, Oregon,Jackson County,41029,2010,203206,180172,181461,21745
2010, Oregon,Polk County,41053,2010,75403,64808,66315,9088
2020, Oregon,Polk County,41053,2020,87433,68274,74703,12730
2000, Oregon,Polk County,41053,2000,62380,55639,56900,5480
2000, Oregon,Benton County,41003,2000,78153,69678,74508,3645
2020, Oregon,Benton County,41003,2020,95184,74612,86660,8524
2020, Oregon,Hood River County,41027,2020,23977,16381,16829,7148
2000, Oregon,Yamhill County,41071,2000,84992,75628,75975,9017
2000, Oregon,Klamath County,41035,2000,63775,55695,58814,4961
2020, Oregon,Klamath County,41035,2020,69413,54494,60641,8772
2010, Oregon,Sherman County,41055,2010,1765,1648,1667,98
2020, Oregon,Jackson County,41029,2020,223259,178193,192860,30399
2020, Oregon,Jefferson County,41031,2020,24502,15992,19500,5002
2000, Oregon,Jefferson County,41031,2000,19009,13113,15637,3372
2010, Oregon,Jefferson County,41031,2010,21720,14996,17525,4195
2000, Oregon,Harney County,41025,2000,7609,6995,7293,316
2020, Oregon,Harney County,41025,2020,7495,6566,7101,394
2010, Oregon,Harney County,41025,2010,7422,6819,7128,294
2010, Oregon,Lincoln County,41041,2010,46034,40393,42379,3655
2010, Oregon,Baker County,41001,2010,16134,15264,15606,528
2000, Oregon,Baker County,41001,2000,16741,16018,16349,392
2010, Oregon,Clackamas County,41005,2010,375992,331571,346854,29138
2020, Oregon,Clackamas County,41005,2020,421401,334855,381059,40342
2000, Oregon,Clackamas County,41005,2000,338391,308852,321647,16744
2010, Oregon,Washington County,41067,2010,529710,405642,446440,83270
2020, Oregon,Washington County,41067,2020,600372,385455,492730,107642
2000, Oregon,Washington County,41067,2000,445342,366007,395607,49735
2010, Oregon,Coos County,41011,2010,63043,56618,59652,3391
2000, Oregon,Coos County,41011,2000,62779,57740,60646,2133
2010, Oregon,Wasco County,41065,2010,25213,21700,21470,3743
2020, Oregon,Baker County,41001,2020,16668,14936,15859,809
2020, Oregon,Coos County,41011,2020,64929,54930,60637,4292
2020, Oregon,Crook County,41013,2020,24738,21349,22935,1803
2000, Oregon,Marion County,41047,2000,284834,232469,236120,48714
2010, Oregon,Deschutes County,41017,2010,157733,145374,146015,11718
2000, Oregon,Malheur County,41045,2000,31615,23959,23516,8099
2010, Oregon,Malheur County,41045,2010,31313,24272,21446,9867
2000, Oregon,Umatilla County,41059,2000,70548,57852,59182,11366
2020, Oregon,Umatilla County,41059,2020,80075,53461,57453,22622
2010, Oregon,Umatilla County,41059,2010,75889,59995,57782,18107
2010, Oregon,Yamhill County,41071,2010,99193,84758,84601,14592
2020, Oregon,Deschutes County,41017,2020,198253,169137,181016,17237
2010, Oregon,Marion County,41047,2010,315335,246656,238741,76594
2020, Oregon,Yamhill County,41071,2020,107722,83667,89929,17793
2020, Oregon,Douglas County,41019,2020,111201,96048,104547,6654
2010, Oregon,Douglas County,41019,2010,107667,99471,102612,5055
2000, Oregon,Douglas County,41019,2000,100399,94234,97116,3283
2020, Oregon,Union County,41061,2020,26196,22565,24849,1347
2010, Oregon,Union County,41061,2010,25748,23968,24746,1002
2000, Oregon,Union County,41061,2000,24530,23129,23930,600
2020, Oregon,Marion County,41047,2020,345920,233321,250180,95740
2000, Oregon,Deschutes County,41017,2000,115367,109423,111063,4304
2020, Oregon,Malheur County,41045,2020,31571,21619,21251,10320
2020, Pennsylvania,Northumberland County,42097,2020,91647,82821,87496,4151
2020, Pennsylvania,Washington County,42125,2020,209349,188060,205328,4021
2020, Pennsylvania,Venango County,42121,2020,50454,47324,49877,577
2000, Pennsylvania,Venango County,42121,2000,57565,56208,57267,298
2020, Pennsylvania,Blair County,42013,2020,122822,113618,121114,1708
2020, Pennsylvania,Fulton County,42057,2020,14556,13767,14410,146
2010, Pennsylvania,Adams County,42001,2010,101407,94979,95292,6115
2020, Pennsylvania,Adams County,42001,2020,103852,91460,96062,7790
2000, Pennsylvania,Adams County,42001,2000,91292,87088,87969,3323
2020, Pennsylvania,Warren County,42123,2020,38587,36447,38172,415
2000, Pennsylvania,Sullivan County,42113,2000,6556,6266,6484,72
2020, Pennsylvania,Sullivan County,42113,2020,5840,5439,5735,105
2010, Pennsylvania,Sullivan County,42113,2010,6428,6163,6336,92
2000, Pennsylvania,Warren County,42123,2000,43863,43286,43712,151
2000, Pennsylvania,Clarion County,42031,2000,41765,40998,41593,172
2020, Pennsylvania,Clarion County,42031,2020,37241,35159,36854,387
2010, Pennsylvania,Warren County,42123,2010,41815,41031,41510,305
2010, Pennsylvania,Berks County,42011,2010,411442,342148,344087,67355
2010, Pennsylvania,Lancaster County,42071,2010,519445,460171,474515,44930
2020, Pennsylvania,Lancaster County,42071,2020,552984,452646,491813,61171
2000, Pennsylvania,Lancaster County,42071,2000,470658,430456,443916,26742
2000, Pennsylvania,Fayette County,42051,2000,148644,141657,148080,564
2020, Pennsylvania,Fayette County,42051,2020,128804,115811,127226,1578
2010, Pennsylvania,Fayette County,42051,2010,136606,127418,135557,1049
2000, Pennsylvania,Washington County,42125,2000,202897,193297,201727,1170
2020, Pennsylvania,Delaware County,42045,2020,576830,367718,550058,26772
2010, Pennsylvania,Clarion County,42031,2010,39988,38873,39743,245
2020, Pennsylvania,Berks County,42011,2020,428849,309107,329299,99550
2020, Pennsylvania,Pike County,42103,2020,58535,47203,51816,6719
2010, Pennsylvania,Pike County,42103,2010,57369,50856,52196,5173
2000, Pennsylvania,Pike County,42103,2000,46302,43109,43987,2315
2000, Pennsylvania,Berks County,42011,2000,373638,329460,337281,36357
2010, Pennsylvania,Delaware County,42045,2010,558979,405233,542442,16537
2020, Pennsylvania,Snyder County,42109,2020,39736,37328,38759,977
2010, Pennsylvania,Centre County,42027,2010,153990,137625,150300,3690
2000, Pennsylvania,Blair County,42013,2000,129144,126059,128482,662
2020, Pennsylvania,Perry County,42099,2020,45842,43173,44930,912
2010, Pennsylvania,Bradford County,42015,2010,62622,61035,61920,702
2000, Pennsylvania,Armstrong County,42005,2000,72392,71173,72084,308
2010, Pennsylvania,Crawford County,42039,2010,88765,85448,87942,823
2020, Pennsylvania,Bradford County,42015,2020,59967,56026,59094,873
2000, Pennsylvania,Bradford County,42015,2000,62761,61471,62363,398
2000, Pennsylvania,Crawford County,42039,2000,90366,87653,89829,537
2010, Pennsylvania,Cameron County,42023,2010,5085,5000,5066,19
2010, Pennsylvania,Monroe County,42089,2010,169842,131162,147554,22288
2020, Pennsylvania,Monroe County,42089,2020,168327,110959,139769,28558
2000, Pennsylvania,Monroe County,42089,2000,138687,122342,129492,9195
2010, Pennsylvania,Lehigh County,42077,2010,349497,276286,283882,65615
2020, Pennsylvania,Lehigh County,42077,2020,374557,244505,277576,96981
2000, Pennsylvania,Lehigh County,42077,2000,312090,271590,280209,31881
2000, Pennsylvania,Philadelphia County,42101,2000,1517550,683267,1388622,128928
2010, Pennsylvania,Philadelphia County,42101,2010,1526006,626221,1338395,187611
2020, Pennsylvania,Philadelphia County,42101,2020,1603797,582636,1365520,238277
2010, Pennsylvania,Blair County,42013,2010,127089,122238,125859,1230
2020, Pennsylvania,Lawrence County,42073,2020,86070,76303,84415,1655
2010, Pennsylvania,Lawrence County,42073,2010,91108,85484,90177,931
2000, Pennsylvania,Centre County,42027,2000,135758,124134,133515,2243
2020, Pennsylvania,Lebanon County,42075,2020,143257,118410,122909,20348
2000, Pennsylvania,Lebanon County,42075,2000,120327,113662,114358,5969
2000, Pennsylvania,Lawrence County,42073,2000,94643,89894,94114,529
2010, Pennsylvania,Lebanon County,42075,2010,133568,121566,121158,12410
2010, Pennsylvania,Susquehanna County,42115,2010,43356,42510,42792,564
2000, Pennsylvania,Susquehanna County,42115,2000,42238,41621,41953,285
2010, Pennsylvania,Venango County,42121,2010,54984,53390,54506,478
2020, Pennsylvania,Centre County,42027,2020,158172,131212,152521,5651
2010, Pennsylvania,Northumberland County,42097,2010,94528,90156,92275,2253
2020, Pennsylvania,York County,42133,2020,456438,373200,417078,39360
2020, Pennsylvania,Susquehanna County,42115,2020,38434,36066,37587,847
2010, Pennsylvania,Perry County,42099,2010,45969,44779,45381,588
2000, Pennsylvania,Snyder County,42109,2000,37546,36768,37178,368
2020, Pennsylvania,Montgomery County,42091,2020,856553,627566,802041,54512
2020, Pennsylvania,McKean County,42083,2020,40432,37273,39790,642
2000, Pennsylvania,Delaware County,42045,2000,550864,442449,542496,8368
2010, Pennsylvania,Union County,42119,2010,44947,39414,42601,2346
2020, Pennsylvania,Union County,42119,2020,42681,36974,40681,2000
2000, Pennsylvania,Union County,42119,2000,41624,37496,40002,1622
2010, Pennsylvania,Wayne County,42127,2010,52822,49759,51006,1816
2000, Pennsylvania,Wayne County,42127,2000,47722,46160,46911,811
2020, Pennsylvania,Erie County,42049,2020,270876,222731,258846,12030
2000, Pennsylvania,Erie County,42049,2000,280843,255282,274717,6126
2010, Pennsylvania,Erie County,42049,2010,280566,247569,271048,9518
2000, Pennsylvania,Jefferson County,42065,2000,45932,45457,45744,188
2020, Pennsylvania,Jefferson County,42065,2020,44492,42470,44095,397
2010, Pennsylvania,Jefferson County,42065,2010,45200,44446,44925,275
2010, Pennsylvania,Wyoming County,42131,2010,28276,27545,27839,437
2000, Pennsylvania,Wyoming County,42131,2000,28080,27598,27893,187
2020, Pennsylvania,Wyoming County,42131,2020,26069,24363,25488,581
2020, Pennsylvania,Elk County,42047,2020,30990,29555,30696,294
2020, Pennsylvania,Juniata County,42067,2020,23509,22084,22601,908
2000, Pennsylvania,Juniata County,42067,2000,22821,22376,22452,369
2010, Pennsylvania,Juniata County,42067,2010,24636,23845,24013,623
2000, Pennsylvania,Elk County,42047,2000,35112,34746,34970,142
2010, Pennsylvania,Elk County,42047,2010,31946,31469,31763,183
2000, Pennsylvania,Clearfield County,42033,2000,83382,81218,82911,471
2000, Pennsylvania,McKean County,42083,2000,45936,44312,45451,485
2020, Pennsylvania,Clearfield County,42033,2020,80562,75093,77925,2637
2020, Pennsylvania,Clinton County,42035,2020,37450,35169,36788,662
2010, Pennsylvania,Potter County,42105,2010,17457,17128,17276,181
2020, Pennsylvania,Potter County,42105,2020,16396,15608,16149,247
2000, Pennsylvania,Potter County,42105,2000,18080,17729,17977,103
2010, Pennsylvania,Clinton County,42035,2010,39238,37860,38801,437
2000, Pennsylvania,Clinton County,42035,2000,37914,37264,37709,205
2010, Pennsylvania,Clearfield County,42033,2010,81642,77912,79735,1907
2020, Pennsylvania,Schuylkill County,42107,2020,143049,128205,134985,8064
2010, Pennsylvania,McKean County,42083,2010,43450,41661,42693,757
2020, Pennsylvania,Wayne County,42127,2020,51155,45795,48808,2347
2010, Pennsylvania,Snyder County,42109,2010,39702,38476,39045,657
2010, Pennsylvania,Montgomery County,42091,2010,799874,649021,765641,34233
2000, Pennsylvania,Montgomery County,42091,2000,750097,648510,734797,15300
2000, Pennsylvania,Schuylkill County,42107,2000,150336,145249,148665,1671
2010, Pennsylvania,Carbon County,42025,2010,65249,62519,63104,2145
2010, Pennsylvania,Bedford County,42009,2010,49762,48782,49312,450
2020, Pennsylvania,Bedford County,42009,2020,47577,45569,47058,519
2000, Pennsylvania,Bedford County,42009,2000,49984,49253,49721,263
2020, Pennsylvania,Carbon County,42025,2020,64749,58531,61107,3642
2000, Pennsylvania,Carbon County,42025,2000,58802,57520,57944,858
2010, Pennsylvania,Schuylkill County,42107,2010,148289,140013,144209,4080
2020, Pennsylvania,Beaver County,42007,2020,168215,144954,164604,3611
2010, Pennsylvania,Beaver County,42007,2010,170539,155561,168541,1998
2000, Pennsylvania,Beaver County,42007,2000,181412,167890,180097,1315
2010, Pennsylvania,Montour County,42093,2010,18267,17408,17943,324
2000, Pennsylvania,Montour County,42093,2000,18236,17628,18069,167
2020, Pennsylvania,Montour County,42093,2020,18136,16248,17649,487
2000, Pennsylvania,Somerset County,42111,2000,80023,77938,79491,532
2020, Pennsylvania,Somerset County,42111,2020,74129,69290,73092,1037
2020, Pennsylvania,Lackawanna County,42069,2020,215896,179038,197629,18267
2000, Pennsylvania,Lackawanna County,42069,2000,213295,206160,210337,2958
2010, Pennsylvania,Lackawanna County,42069,2010,214437,197296,203755,10682
2000, Pennsylvania,Indiana County,42063,2000,89605,86796,89148,457
2010, Pennsylvania,Somerset County,42111,2010,77742,74603,76902,840
2010, Pennsylvania,Indiana County,42063,2010,88880,84360,87933,947
2020, Pennsylvania,Columbia County,42037,2020,64727,59549,62587,2140
2000, Pennsylvania,Columbia County,42037,2000,64151,62602,63542,609
2010, Pennsylvania,Columbia County,42037,2010,67295,64227,65946,1349
2020, Pennsylvania,Huntingdon County,42061,2020,44092,39624,43240,852
2000, Pennsylvania,Huntingdon County,42061,2000,45586,42544,45062,524
2010, Pennsylvania,Huntingdon County,42061,2010,45913,42470,45186,727
2020, Pennsylvania,Indiana County,42063,2020,83246,76277,81770,1476
2000, Pennsylvania,Perry County,42099,2000,43602,42964,43301,301
2010, Pennsylvania,Mercer County,42085,2010,116638,106890,115390,1248
2020, Pennsylvania,Crawford County,42039,2020,83938,77804,82697,1241
2000, Pennsylvania,Chester County,42029,2000,433501,386745,417375,16126
2020, Pennsylvania,Mercer County,42085,2020,110652,97516,109043,1609
2000, Pennsylvania,Lycoming County,42081,2000,120044,112737,119245,799
2000, Pennsylvania,Butler County,42019,2000,174083,170302,173067,1016
2020, Pennsylvania,Tioga County,42117,2020,41045,38477,40405,640
2010, Pennsylvania,Cambria County,42021,2010,143679,135206,141673,2006
2020, Pennsylvania,Lycoming County,42081,2020,114188,100428,111814,2374
2010, Pennsylvania,Lycoming County,42081,2010,116111,107573,114552,1559
2010, Pennsylvania,Washington County,42125,2010,207820,195657,205454,2366
2010, Pennsylvania,Luzerne County,42079,2010,320918,290943,299427,21491
2000, Pennsylvania,Luzerne County,42079,2000,319250,308476,315537,3713
2020, Pennsylvania,Luzerne County,42079,2020,325594,257042,278696,46898
2000, Pennsylvania,Dauphin County,42043,2000,251798,194158,241394,10404
2020, Pennsylvania,Cambria County,42021,2020,133472,120248,131007,2465
2010, Pennsylvania,Allegheny County,42003,2010,1223348,997295,1204278,19070
2020, Pennsylvania,Chester County,42029,2020,534413,413103,490871,43542
2010, Pennsylvania,York County,42133,2010,434972,385135,410575,24397
2000, Pennsylvania,York County,42133,2000,381751,354103,370455,11296
2010, Pennsylvania,Tioga County,42117,2010,41981,40852,41544,437
2010, Pennsylvania,Westmoreland County,42129,2010,365169,348182,361990,3179
2020, Pennsylvania,Greene County,42059,2020,35954,33027,35444,510
2000, Pennsylvania,Greene County,42059,2000,40672,38665,40315,357
2000, Pennsylvania,Cambria County,42021,2000,152598,146183,151246,1352
2000, Pennsylvania,Franklin County,42055,2000,129313,123279,127045,2268
2020, Pennsylvania,Franklin County,42055,2020,155932,134524,145168,10764
2010, Pennsylvania,Mifflin County,42087,2010,46682,45531,46148,534
2020, Pennsylvania,Dauphin County,42043,2020,286401,180980,255150,31251
2000, Pennsylvania,Tioga County,42117,2000,41373,40589,41159,214
2000, Pennsylvania,Mifflin County,42087,2000,46486,45803,46223,263
2010, Pennsylvania,Greene County,42059,2010,38686,36584,38221,465
2000, Pennsylvania,Allegheny County,42003,2000,1281666,1080800,1270500,11166
2020, Pennsylvania,Allegheny County,42003,2020,1250578,946321,1216253,34325
2010, Pennsylvania,Dauphin County,42043,2010,268100,194910,249305,18795
2020, Pennsylvania,Forest County,42053,2020,6973,5296,6650,323
2000, Pennsylvania,Bucks County,42017,2000,597635,552588,583630,14005
2020, Pennsylvania,Bucks County,42017,2020,646538,529895,606768,39770
2000, Pennsylvania,Northumberland County,42097,2000,94556,91803,93515,1041
2020, Pennsylvania,Butler County,42019,2020,193763,179140,190098,3665
2000, Pennsylvania,Fulton County,42057,2000,14261,14012,14209,52
2010, Pennsylvania,Bucks County,42017,2010,625249,557647,598467,26782
2010, Pennsylvania,Fulton County,42057,2010,14845,14450,14722,123
2000, Pennsylvania,Mercer County,42085,2000,120293,112031,119490,803
2010, Pennsylvania,Butler County,42019,2010,183862,177605,181921,1941
2020, Pennsylvania,Cumberland County,42041,2020,259469,214921,247494,11975
2010, Pennsylvania,Chester County,42029,2010,498886,426707,466383,32503
2000, Pennsylvania,Forest County,42053,2000,4946,4745,4886,60
2000, Pennsylvania,Cumberland County,42041,2000,213674,201716,210791,2883
2010, Pennsylvania,Forest County,42053,2010,7716,5937,7298,418
2010, Pennsylvania,Northampton County,42095,2010,297735,256895,266556,31179
2010, Pennsylvania,Franklin County,42055,2010,149618,137674,143180,6438
2020, Pennsylvania,Armstrong County,42005,2020,65558,62513,65068,490
2010, Pennsylvania,Cumberland County,42041,2010,235406,213934,228958,6448
2020, Pennsylvania,Northampton County,42095,2020,312951,238475,268354,44597
2020, Pennsylvania,Cameron County,42023,2020,4547,4285,4461,86
2020, Pennsylvania,Mifflin County,42087,2020,46143,43644,45164,979
2020, Pennsylvania,Westmoreland County,42129,2020,354663,324684,349433,5230
2010, Pennsylvania,Armstrong County,42005,2010,68941,67565,68575,366
2000, Pennsylvania,Westmoreland County,42129,2000,369993,357325,368124,1869
2000, Pennsylvania,Northampton County,42095,2000,267066,243639,249198,17868
2000, Pennsylvania,Cameron County,42023,2000,5974,5904,5940,34
2020, Puerto Rico,Trujillo Alto Municipio,72139,2020,67740,9651,614,67126
2000, Puerto Rico,Salinas Municipio,72123,2000,31113,23202,218,30895
2010, Puerto Rico,Barceloneta Municipio,72017,2010,24816,20028,157,24659
2000, Puerto Rico,Trujillo Alto Municipio,72139,2000,75728,58712,827,74901
2000, Puerto Rico,Barceloneta Municipio,72017,2000,22322,18099,129,22193
2020, Puerto Rico,San Juan Municipio,72127,2020,342259,49388,7658,334601
2000, Puerto Rico,San Juan Municipio,72127,2000,434374,315939,8722,425652
2010, Puerto Rico,San Juan Municipio,72127,2010,395326,268708,7140,388186
2000, Puerto Rico,Fajardo Municipio,72053,2000,40712,29722,1127,39585
2010, Puerto Rico,Barranquitas Municipio,72019,2010,30318,26082,208,30110
2020, Puerto Rico,Arroyo Municipio,72015,2020,15843,1816,135,15708
2010, Puerto Rico,Humacao Municipio,72069,2010,58466,38666,610,57856
2020, Puerto Rico,Humacao Municipio,72069,2020,50896,6861,993,49903
2000, Puerto Rico,Humacao Municipio,72069,2000,59035,41168,747,58288
2010, Puerto Rico,Lajas Municipio,72079,2010,25753,20750,175,25578
2020, Puerto Rico,Lajas Municipio,72079,2020,23334,4421,174,23160
2000, Puerto Rico,Lajas Municipio,72079,2000,26261,22777,208,26053
2010, Puerto Rico,Bayamón Municipio,72021,2010,208116,162893,2108,206008
2000, Puerto Rico,Bayamón Municipio,72021,2000,224044,190101,2900,221144
2020, Puerto Rico,Bayamón Municipio,72021,2020,185187,33084,1924,183263
2010, Puerto Rico,Toa Baja Municipio,72137,2010,89609,62920,925,88684
2020, Puerto Rico,Aibonito Municipio,72009,2020,24637,4785,227,24410
2000, Puerto Rico,Loíza Municipio,72087,2000,32537,9679,194,32343
2000, Puerto Rico,San Lorenzo Municipio,72129,2000,40997,33380,240,40757
2010, Puerto Rico,Loíza Municipio,72087,2010,30060,7974,177,29883
2010, Puerto Rico,Patillas Municipio,72109,2010,19277,11902,126,19151
2020, Puerto Rico,Patillas Municipio,72109,2020,15985,2543,107,15878
2020, Puerto Rico,Isabela Municipio,72071,2020,42943,7512,548,42395
2020, Puerto Rico,Barranquitas Municipio,72019,2020,28983,6029,78,28905
2000, Puerto Rico,Barranquitas Municipio,72019,2000,28909,25729,155,28754
2010, Puerto Rico,Isabela Municipio,72071,2010,45631,38058,438,45193
2000, Puerto Rico,Isabela Municipio,72071,2000,44444,38950,435,44009
2020, Puerto Rico,Carolina Municipio,72031,2020,154815,21998,2398,152417
2000, Puerto Rico,Patillas Municipio,72109,2000,20152,13633,141,20011
2000, Puerto Rico,Aibonito Municipio,72009,2000,26493,23475,141,26352
2000, Puerto Rico,Arroyo Municipio,72015,2000,19117,8844,178,18939
2020, Puerto Rico,Barceloneta Municipio,72017,2020,22657,3584,115,22542
2020, Puerto Rico,Loíza Municipio,72087,2020,23693,1376,144,23549
2010, Puerto Rico,Rincón Municipio,72117,2010,15200,13025,540,14660
2000, Puerto Rico,Jayuya Municipio,72073,2000,17318,16055,98,17220
2020, Puerto Rico,Rincón Municipio,72117,2020,15187,3252,778,14409
2000, Puerto Rico,Vega Alta Municipio,72143,2000,37910,33397,241,37669
2020, Puerto Rico,Yabucoa Municipio,72151,2020,30426,5028,168,30258
2000, Puerto Rico,Ceiba Municipio,72037,2000,18004,12126,3368,14636
2020, Puerto Rico,Ceiba Municipio,72037,2020,11307,1814,208,11099
2020, Puerto Rico,Santa Isabel Municipio,72133,2020,20281,3176,115,20166
2010, Puerto Rico,Ceiba Municipio,72037,2010,13631,9623,170,13461
2010, Puerto Rico,Caguas Municipio,72025,2010,142893,108767,1225,141668
2020, Puerto Rico,San Germán Municipio,72125,2020,31879,5882,240,31639
2010, Puerto Rico,San Germán Municipio,72125,2010,35527,29614,275,35252
2000, Puerto Rico,Caguas Municipio,72025,2000,140502,118709,1143,139359
2000, Puerto Rico,San Germán Municipio,72125,2000,37105,32141,383,36722
2000, Puerto Rico,Morovis Municipio,72101,2000,29965,27917,195,29770
2020, Puerto Rico,Morovis Municipio,72101,2020,28727,5501,123,28604
2010, Puerto Rico,Vega Alta Municipio,72143,2010,39951,28443,503,39448
2010, Puerto Rico,Morovis Municipio,72101,2010,32610,28828,185,32425
2010, Puerto Rico,Utuado Municipio,72141,2010,33149,30719,193,32956
2000, Puerto Rico,Maunabo Municipio,72095,2000,12741,7665,71,12670
2010, Puerto Rico,Juana Díaz Municipio,72075,2010,50747,38196,310,50437
2020, Puerto Rico,Maunabo Municipio,72095,2020,10589,967,59,10530
2010, Puerto Rico,Maunabo Municipio,72095,2010,12225,5851,93,12132
2020, Puerto Rico,Juana Díaz Municipio,72075,2020,46538,6726,253,46285
2000, Puerto Rico,Juana Díaz Municipio,72075,2000,50531,39536,265,50266
2020, Puerto Rico,Juncos Municipio,72077,2020,37012,4827,218,36794
2010, Puerto Rico,Juncos Municipio,72077,2010,40290,28878,287,40003
2000, Puerto Rico,Juncos Municipio,72077,2000,36452,30698,199,36253
2000, Puerto Rico,Mayagüez Municipio,72097,2000,98434,81971,967,97467
2020, Puerto Rico,Mayagüez Municipio,72097,2020,73077,14372,970,72107
2010, Puerto Rico,Mayagüez Municipio,72097,2010,89080,70091,948,88132
2020, Puerto Rico,Caguas Municipio,72025,2020,127244,20215,974,126270
2000, Puerto Rico,Rincón Municipio,72117,2000,14767,13381,349,14418
2000, Puerto Rico,Yabucoa Municipio,72151,2000,39246,26902,271,38975
2000, Puerto Rico,Utuado Municipio,72141,2000,35336,33457,246,35090
2010, Puerto Rico,Trujillo Alto Municipio,72139,2010,74842,53995,813,74029
2020, Puerto Rico,Cabo Rojo Municipio,72023,2020,47158,9561,569,46589
2000, Puerto Rico,Vega Baja Municipio,72145,2000,61929,54243,516,61413
2010, Puerto Rico,Ponce Municipio,72113,2010,166327,136447,1372,164955
2000, Puerto Rico,Ponce Municipio,72113,2000,186475,155907,1873,184602
2020, Puerto Rico,Ponce Municipio,72113,2020,137491,26148,1191,136300
2000, Puerto Rico,Luquillo Municipio,72089,2000,19817,13544,490,19327
2010, Puerto Rico,Jayuya Municipio,72073,2010,16642,15094,60,16582
2020, Puerto Rico,Jayuya Municipio,72073,2020,14779,3447,76,14703
2020, Puerto Rico,Luquillo Municipio,72089,2020,17781,3052,518,17263
2000, Puerto Rico,Cabo Rojo Municipio,72023,2000,46911,41572,446,46465
2010, Puerto Rico,Cabo Rojo Municipio,72023,2010,50917,42815,541,50376
2010, Puerto Rico,Quebradillas Municipio,72115,2010,25919,23113,171,25748
2010, Puerto Rico,Yabucoa Municipio,72151,2010,37941,24888,255,37686
2000, Puerto Rico,Santa Isabel Municipio,72133,2000,21665,15998,153,21512
2010, Puerto Rico,Añasco Municipio,72011,2010,29261,23997,227,29034
2020, Puerto Rico,Coamo Municipio,72043,2020,34668,6938,204,34464
2000, Puerto Rico,Coamo Municipio,72043,2000,37597,30264,226,37371
2010, Puerto Rico,Santa Isabel Municipio,72133,2010,23274,16995,103,23171
2010, Puerto Rico,Vega Baja Municipio,72145,2010,59662,46113,439,59223
2020, Puerto Rico,Vega Baja Municipio,72145,2020,54414,10042,402,54012
2020, Puerto Rico,Vega Alta Municipio,72143,2020,35395,4373,428,34967
2000, Puerto Rico,Quebradillas Municipio,72115,2000,25450,23970,170,25280
2010, Puerto Rico,Luquillo Municipio,72089,2010,20068,13153,417,19651
2000, Puerto Rico,Añasco Municipio,72011,2000,28348,24170,201,28147
2020, Puerto Rico,Añasco Municipio,72011,2020,25596,4701,252,25344
2020, Puerto Rico,Quebradillas Municipio,72115,2020,23638,6010,197,23441
2020, Puerto Rico,Utuado Municipio,72141,2020,28287,6119,215,28072
2010, Puerto Rico,Coamo Municipio,72043,2010,40512,31129,174,40338
2020, Puerto Rico,Toa Baja Municipio,72137,2020,75293,12240,778,74515
2010, Puerto Rico,Salinas Municipio,72123,2010,31078,20953,213,30865
2020, Puerto Rico,Naguabo Municipio,72103,2020,23386,3119,196,23190
2020, Puerto Rico,Ciales Municipio,72039,2020,16984,3530,93,16891
2010, Puerto Rico,Yauco Municipio,72153,2010,42043,34899,212,41831
2010, Puerto Rico,Aguadilla Municipio,72005,2010,60949,50589,903,60046
2010, Puerto Rico,Aguada Municipio,72003,2010,41959,36350,258,41701
2020, Puerto Rico,Aguada Municipio,72003,2020,38136,8673,276,37860
2000, Puerto Rico,Cidra Municipio,72041,2000,42753,35346,267,42486
2020, Puerto Rico,Cidra Municipio,72041,2020,39970,7813,208,39762
2020, Puerto Rico,Hatillo Municipio,72065,2020,38486,8170,315,38171
2010, Puerto Rico,Hatillo Municipio,72065,2010,41953,36608,349,41604
2000, Puerto Rico,Hatillo Municipio,72065,2000,38925,35268,318,38607
2020, Puerto Rico,Yauco Municipio,72153,2020,34172,7312,190,33982
2000, Puerto Rico,Yauco Municipio,72153,2000,46384,41624,287,46097
2000, Puerto Rico,Sabana Grande Municipio,72121,2000,25935,22983,148,25787
2000, Puerto Rico,Ciales Municipio,72039,2000,19811,18293,114,19697
2000, Puerto Rico,Maricao Municipio,72093,2000,6449,5824,56,6393
2020, Puerto Rico,Adjuntas Municipio,72001,2020,18020,3992,59,17961
2000, Puerto Rico,Adjuntas Municipio,72001,2000,19143,18215,66,19077
2010, Puerto Rico,Cidra Municipio,72041,2010,43480,33317,241,43239
2010, Puerto Rico,Maricao Municipio,72093,2010,6276,5600,39,6237
2000, Puerto Rico,Río Grande Municipio,72119,2000,52362,34577,641,51721
2020, Puerto Rico,Maricao Municipio,72093,2020,4755,1056,26,4729
2020, Puerto Rico,Vieques Municipio,72147,2020,8249,1551,663,7586
2010, Puerto Rico,Vieques Municipio,72147,2010,9301,5456,526,8775
2020, Puerto Rico,Sabana Grande Municipio,72121,2020,22729,4513,127,22602
2010, Puerto Rico,Culebra Municipio,72049,2010,1818,1035,150,1668
2000, Puerto Rico,Camuy Municipio,72027,2000,35244,32315,277,34967
2020, Puerto Rico,Camuy Municipio,72027,2020,32827,7448,302,32525
2010, Puerto Rico,Camuy Municipio,72027,2010,35159,30900,209,34950
2000, Puerto Rico,Aguada Municipio,72003,2000,42042,37280,295,41747
2010, Puerto Rico,Ciales Municipio,72039,2010,18782,16815,57,18725
2000, Puerto Rico,San Sebastián Municipio,72131,2000,44204,41290,223,43981
2020, Puerto Rico,Guayama Municipio,72057,2020,36614,6969,243,36371
2020, Puerto Rico,Guánica Municipio,72055,2020,13787,2353,124,13663
2010, Puerto Rico,Aibonito Municipio,72009,2010,25900,21622,171,25729
2010, Puerto Rico,Guánica Municipio,72055,2010,19427,15520,126,19301
2000, Puerto Rico,Aguas Buenas Municipio,72007,2000,29032,24088,201,28831
2010, Puerto Rico,Aguas Buenas Municipio,72007,2010,28659,20770,146,28513
2010, Puerto Rico,Río Grande Municipio,72119,2010,54304,33601,542,53762
2000, Puerto Rico,Guánica Municipio,72055,2000,21888,18443,130,21758
2000, Puerto Rico,Gurabo Municipio,72063,2000,36743,28400,360,36383
2020, Puerto Rico,Aguas Buenas Municipio,72007,2020,24223,3512,132,24091
2010, Puerto Rico,Gurabo Municipio,72063,2010,45369,32871,354,45015
2020, Puerto Rico,Gurabo Municipio,72063,2020,40622,6170,306,40316
2000, Puerto Rico,Aguadilla Municipio,72005,2000,64685,54084,1216,63469
2020, Puerto Rico,Aguadilla Municipio,72005,2020,55101,11566,874,54227
2020, Puerto Rico,Florida Municipio,72054,2020,11692,1619,55,11637
2010, Puerto Rico,Florida Municipio,72054,2010,12680,11467,56,12624
2000, Puerto Rico,Guaynabo Municipio,72061,2000,100053,80171,2414,97639
2010, Puerto Rico,Peñuelas Municipio,72111,2010,24282,19854,156,24126
2000, Puerto Rico,Peñuelas Municipio,72111,2000,26719,22244,175,26544
2020, Puerto Rico,Peñuelas Municipio,72111,2020,20399,4714,100,20299
2010, Puerto Rico,San Sebastián Municipio,72131,2010,42430,37549,286,42144
2020, Puerto Rico,San Sebastián Municipio,72131,2020,39345,7572,235,39110
2000, Puerto Rico,Florida Municipio,72054,2000,12367,11381,80,12287
2010, Puerto Rico,Guaynabo Municipio,72061,2010,97924,77715,1731,96193
2020, Puerto Rico,Guaynabo Municipio,72061,2020,89780,15415,1886,87894
2020, Puerto Rico,Guayanilla Municipio,72059,2020,17784,3213,63,17721
2010, Puerto Rico,Guayanilla Municipio,72059,2010,21581,17675,106,21475
2000, Puerto Rico,Guayanilla Municipio,72059,2000,23072,18640,122,22950
2010, Puerto Rico,Guayama Municipio,72057,2010,45362,30917,404,44958
2000, Puerto Rico,Guayama Municipio,72057,2000,44301,33014,361,43940
2000, Puerto Rico,Toa Baja Municipio,72137,2000,94085,70597,1323,92762
2010, Puerto Rico,Manatí Municipio,72091,2010,44113,36092,334,43779
2000, Puerto Rico,Manatí Municipio,72091,2000,45409,38694,243,45166
2020, Puerto Rico,Cataño Municipio,72033,2020,23155,3016,232,22923
2000, Puerto Rico,Orocovis Municipio,72107,2000,23844,19401,197,23647
2020, Puerto Rico,Orocovis Municipio,72107,2020,21434,3493,96,21338
2000, Puerto Rico,Dorado Municipio,72051,2000,34017,25219,610,33407
2000, Puerto Rico,Hormigueros Municipio,72067,2000,16614,14283,170,16444
2020, Puerto Rico,Cayey Municipio,72035,2020,41652,7233,252,41400
2010, Puerto Rico,Comerío Municipio,72045,2010,20778,16328,87,20691
2020, Puerto Rico,Moca Municipio,72099,2020,37460,6355,144,37316
2000, Puerto Rico,Moca Municipio,72099,2000,39697,36183,317,39380
2010, Puerto Rico,Moca Municipio,72099,2010,40109,35897,224,39885
2000, Puerto Rico,Villalba Municipio,72149,2000,27913,23063,126,27787
2020, Puerto Rico,Hormigueros Municipio,72067,2020,15654,2937,118,15536
2010, Puerto Rico,Hormigueros Municipio,72067,2010,17250,14000,92,17158
2010, Puerto Rico,Naranjito Municipio,72105,2010,30402,25588,138,30264
2020, Puerto Rico,Naranjito Municipio,72105,2020,29241,6046,110,29131
2000, Puerto Rico,Naranjito Municipio,72105,2000,29709,27328,144,29565
2020, Puerto Rico,Salinas Municipio,72123,2020,25789,4196,212,25577
2020, Puerto Rico,Río Grande Municipio,72119,2020,47060,6896,576,46484
2000, Puerto Rico,Toa Alta Municipio,72135,2000,63929,52657,511,63418
2010, Puerto Rico,Arroyo Municipio,72015,2010,19575,10469,185,19390
2020, Puerto Rico,Fajardo Municipio,72053,2020,32124,4653,570,31554
2010, Puerto Rico,Fajardo Municipio,72053,2010,36993,23964,651,36342
2010, Puerto Rico,San Lorenzo Municipio,72129,2010,41058,31240,198,40860
2010, Puerto Rico,Carolina Municipio,72031,2010,176762,113683,2528,174234
2000, Puerto Rico,Carolina Municipio,72031,2000,186076,128475,2951,183125
2020, Puerto Rico,San Lorenzo Municipio,72129,2020,37693,5260,173,37520
2010, Puerto Rico,Toa Alta Municipio,72135,2010,74066,56538,500,73566
2020, Puerto Rico,Toa Alta Municipio,72135,2020,66852,10853,399,66453
2010, Puerto Rico,Naguabo Municipio,72103,2010,26720,19011,208,26512
2000, Puerto Rico,Naguabo Municipio,72103,2000,23753,18073,243,23510
2010, Puerto Rico,Orocovis Municipio,72107,2010,23423,20304,98,23325
2020, Puerto Rico,Manatí Municipio,72091,2020,39492,6758,294,39198
2010, Puerto Rico,Cayey Municipio,72035,2010,48119,38435,313,47806
2010, Puerto Rico,Dorado Municipio,72051,2010,38165,26537,747,37418
2000, Puerto Rico,Culebra Municipio,72049,2000,1868,1132,172,1696
2010, Puerto Rico,Corozal Municipio,72047,2010,37142,31706,215,36927
2020, Puerto Rico,Corozal Municipio,72047,2020,34571,6841,175,34396
2010, Puerto Rico,Adjuntas Municipio,72001,2010,19483,18146,82,19401
2010, Puerto Rico,Sabana Grande Municipio,72121,2010,25265,21550,126,25139
2020, Puerto Rico,Culebra Municipio,72049,2020,1792,317,193,1599
2000, Puerto Rico,Canóvanas Municipio,72029,2000,43335,27693,319,43016
2020, Puerto Rico,Canóvanas Municipio,72029,2020,42337,5672,293,42044
2010, Puerto Rico,Canóvanas Municipio,72029,2010,47648,29165,363,47285
2010, Puerto Rico,Cataño Municipio,72033,2010,28140,19899,274,27866
2020, Puerto Rico,Arecibo Municipio,72013,2020,87754,16636,637,87117
2000, Puerto Rico,Vieques Municipio,72147,2000,9106,6621,236,8870
2000, Puerto Rico,Cataño Municipio,72033,2000,30071,20427,418,29653
2000, Puerto Rico,Cayey Municipio,72035,2000,47370,41771,328,47042
2020, Puerto Rico,Dorado Municipio,72051,2020,35879,6317,1213,34666
2020, Puerto Rico,Villalba Municipio,72149,2020,22093,3429,85,22008
2000, Puerto Rico,Las Piedras Municipio,72085,2000,34485,28926,239,34246
2010, Puerto Rico,Lares Municipio,72081,2010,30753,28006,218,30535
2000, Puerto Rico,Lares Municipio,72081,2000,34415,32937,187,34228
2020, Puerto Rico,Lares Municipio,72081,2020,28105,5772,196,27909
2000, Puerto Rico,Comerío Municipio,72045,2000,20002,17815,75,19927
2010, Puerto Rico,Las Piedras Municipio,72085,2010,38675,27258,240,38435
2020, Puerto Rico,Las Marías Municipio,72083,2020,8874,1528,71,8803
2020, Puerto Rico,Comerío Municipio,72045,2020,18883,3187,71,18812
2000, Puerto Rico,Las Marías Municipio,72083,2000,11061,10220,74,10987
2010, Puerto Rico,Las Marías Municipio,72083,2010,9881,8523,60,9821
2020, Puerto Rico,Las Piedras Municipio,72085,2020,35180,5478,197,34983
2010, Puerto Rico,Arecibo Municipio,72013,2010,96440,81518,763,95677
2010, Puerto Rico,Villalba Municipio,72149,2010,26073,21405,90,25983
2000, Puerto Rico,Arecibo Municipio,72013,2000,100131,89034,838,99293
2000, Puerto Rico,Corozal Municipio,72047,2000,36867,33800,159,36708
2020, Rhode Island,Providence County,44007,2020,660741,402194,500418,160323
2000, Rhode Island,Providence County,44007,2000,621602,487235,538370,83232
2010, Rhode Island,Providence County,44007,2010,626667,460033,508848,117819
2000, Rhode Island,Kent County,44003,2000,167090,159645,164263,2827
2010, Rhode Island,Newport County,44005,2010,82888,74729,79376,3512
2000, Rhode Island,Bristol County,44001,2000,50648,49034,50076,572
2000, Rhode Island,Newport County,44005,2000,85433,78136,83024,2409
2020, Rhode Island,Newport County,44005,2020,85643,72063,80051,5592
2010, Rhode Island,Bristol County,44001,2010,49875,47752,48886,989
2020, Rhode Island,Washington County,44009,2020,129839,116202,125261,4578
2010, Rhode Island,Washington County,44009,2010,126979,119136,123953,3026
2020, Rhode Island,Bristol County,44001,2020,50793,45355,48850,1943
2020, Rhode Island,Kent County,44003,2020,170363,147106,160698,9665
2010, Rhode Island,Kent County,44003,2010,166158,155219,160849,5309
2000, Rhode Island,Washington County,44009,2000,123546,117141,121766,1780
2000, South Carolina,York County,45091,2000,164614,127162,161394,3220
2000, South Carolina,Georgetown County,45043,2000,55797,33307,54878,919
2020, South Carolina,Georgetown County,45043,2020,63404,41555,61179,2225
2010, South Carolina,York County,45091,2010,226073,169158,215998,10075
2020, South Carolina,York County,45091,2020,282090,191849,263152,18938
2020, South Carolina,Florence County,45041,2020,137059,69755,132776,4283
2010, South Carolina,Florence County,45041,2010,136885,75116,133855,3030
2000, South Carolina,Florence County,45041,2000,125761,73760,124378,1383
2020, South Carolina,Marion County,45067,2020,29183,11205,28473,710
2010, South Carolina,Georgetown County,45043,2010,60158,38005,58291,1867
2000, South Carolina,Richland County,45079,2000,320677,161276,311964,8713
2000, South Carolina,Marion County,45067,2000,35466,14787,34832,634
2010, South Carolina,Aiken County,45003,2010,160099,111457,152275,7824
2000, South Carolina,Dorchester County,45035,2000,96413,68498,94691,1722
2010, South Carolina,Dorchester County,45035,2010,136555,92621,130480,6075
2020, South Carolina,Dorchester County,45035,2020,161540,101446,150679,10861
2010, South Carolina,McCormick County,45065,2010,10233,4985,10152,81
2020, South Carolina,McCormick County,45065,2020,9526,5182,9403,123
2020, South Carolina,Richland County,45079,2020,416147,177274,390052,26095
2020, South Carolina,Edgefield County,45037,2020,25657,15334,24286,1371
2010, South Carolina,Edgefield County,45037,2010,26985,15825,25571,1414
2010, South Carolina,Marion County,45067,2010,33062,13434,32271,791
2000, South Carolina,Edgefield County,45037,2000,24595,13962,24092,503
2010, South Carolina,Union County,45087,2010,28961,19286,28679,282
2020, South Carolina,Union County,45087,2020,27244,17388,26806,438
2020, South Carolina,Fairfield County,45039,2020,20948,8571,20525,423
2010, South Carolina,Fairfield County,45039,2010,23956,9236,23582,374
2000, South Carolina,Fairfield County,45039,2000,23454,9282,23204,250
2010, South Carolina,Marlboro County,45069,2010,28933,11987,28133,800
2000, South Carolina,Marlboro County,45069,2000,28818,12820,28613,205
2020, South Carolina,Marlboro County,45069,2020,26667,10839,26092,575
2000, South Carolina,Union County,45087,2000,29881,20262,29682,199
2000, South Carolina,Aiken County,45003,2000,142552,101745,139527,3025
2020, South Carolina,Greenville County,45045,2020,525534,353260,467509,58025
2000, South Carolina,Dillon County,45033,2000,30722,15481,30183,539
2010, South Carolina,Lancaster County,45057,2010,76652,54844,73268,3384
2000, South Carolina,Lancaster County,45057,2000,61351,43577,60373,978
2020, South Carolina,Horry County,45051,2020,351029,270736,326725,24304
2010, South Carolina,Horry County,45051,2010,269291,215071,252608,16683
2000, South Carolina,Horry County,45051,2000,196629,159363,191572,5057
2020, South Carolina,Jasper County,45053,2020,28791,13715,23712,5079
2010, South Carolina,Jasper County,45053,2010,24777,10658,21025,3752
2020, South Carolina,Lancaster County,45057,2020,96016,66147,89722,6294
2000, South Carolina,Jasper County,45053,2000,20678,8766,19488,1190
2000, South Carolina,Spartanburg County,45083,2000,253791,190569,246710,7081
2020, South Carolina,Spartanburg County,45083,2020,327997,219423,300265,27732
2020, South Carolina,Kershaw County,45055,2020,65403,44053,61937,3466
2000, South Carolina,Kershaw County,45055,2000,52647,37701,51761,886
2010, South Carolina,Kershaw County,45055,2010,61697,43965,59399,2298
2020, South Carolina,Abbeville County,45001,2020,24295,16877,23872,423
2010, South Carolina,Abbeville County,45001,2010,25417,17691,25162,255
2010, South Carolina,Spartanburg County,45083,2010,284307,205680,267649,16658
2010, South Carolina,Laurens County,45059,2010,66537,46848,63808,2729
2000, South Carolina,Laurens County,45059,2000,69567,49789,68215,1352
2020, South Carolina,Laurens County,45059,2020,67539,45080,63392,4147
2000, South Carolina,Greenville County,45045,2000,379616,294324,365333,14283
2010, South Carolina,Greenville County,45045,2010,451225,333084,414730,36495
2000, South Carolina,Greenwood County,45047,2000,66271,43455,64369,1902
2020, South Carolina,Greenwood County,45047,2020,69351,41205,64602,4749
2010, South Carolina,Greenwood County,45047,2010,69661,43783,65872,3789
2000, South Carolina,Lexington County,45063,2000,216014,181844,211868,4146
2020, South Carolina,Lexington County,45063,2020,293991,212701,272194,21797
2010, South Carolina,Lexington County,45063,2010,262391,208023,247862,14529
2000, South Carolina,Hampton County,45049,2000,21386,9173,20839,547
2020, South Carolina,Hampton County,45049,2020,18561,8135,17895,666
2010, South Carolina,Hampton County,45049,2010,21090,8999,20346,744
2010, South Carolina,Lee County,45061,2010,19220,6419,18886,334
2000, South Carolina,Lee County,45061,2000,20119,7048,19855,264
2020, South Carolina,Lee County,45061,2020,16531,5771,16236,295
2010, South Carolina,Sumter County,45085,2010,107456,51825,103924,3532
2000, South Carolina,Sumter County,45085,2000,104646,52462,102728,1918
2020, South Carolina,Sumter County,45085,2020,105556,47406,101254,4302
2020, South Carolina,Aiken County,45003,2020,168808,110016,157282,11526
2010, South Carolina,Dillon County,45033,2010,32062,15399,31229,833
2000, South Carolina,McCormick County,45065,2000,9958,4459,9872,86
2010, South Carolina,Darlington County,45031,2010,68681,38366,67541,1140
2010, South Carolina,Calhoun County,45017,2010,15175,8177,14717,458
2000, South Carolina,Calhoun County,45017,2000,15185,7597,14973,212
2020, South Carolina,Orangeburg County,45075,2020,84223,28070,82256,1967
2000, South Carolina,Orangeburg County,45075,2000,91582,34045,90707,875
2010, South Carolina,Orangeburg County,45075,2010,92501,31770,90734,1767
2000, South Carolina,Oconee County,45073,2000,66215,59025,64653,1562
2020, South Carolina,Oconee County,45073,2020,78607,65766,74223,4384
2020, South Carolina,Calhoun County,45017,2020,14119,7896,13632,487
2010, South Carolina,Oconee County,45073,2010,74273,65177,70924,3349
2010, South Carolina,Charleston County,45019,2010,350209,224910,331332,18877
2000, South Carolina,Charleston County,45019,2000,309969,191928,302535,7434
2010, South Carolina,Cherokee County,45021,2010,55342,41525,53310,2032
2000, South Carolina,Cherokee County,45021,2000,52537,40409,51445,1092
2020, South Carolina,Cherokee County,45021,2020,56216,40203,53439,2777
2020, South Carolina,Dillon County,45033,2020,28292,13151,27436,856
2010, South Carolina,Chester County,45023,2010,33140,19814,32661,479
2020, South Carolina,Charleston County,45019,2020,408235,268699,378955,29280
2000, South Carolina,Chester County,45023,2000,34068,20416,33813,255
2000, South Carolina,Williamsburg County,45089,2000,37217,12184,36944,273
2010, South Carolina,Williamsburg County,45089,2010,34423,10939,33734,689
2010, South Carolina,Richland County,45079,2010,384504,181974,365867,18637
2000, South Carolina,Bamberg County,45009,2000,16658,6075,16540,118
2020, South Carolina,Bamberg County,45009,2020,13311,5046,13170,141
2010, South Carolina,Bamberg County,45009,2010,15987,5770,15729,258
2000, South Carolina,Barnwell County,45011,2000,23478,12956,23151,327
2020, South Carolina,Barnwell County,45011,2020,20589,10493,20069,520
2010, South Carolina,Barnwell County,45011,2010,22621,11899,22210,411
2020, South Carolina,Williamsburg County,45089,2020,31026,10249,30407,619
2010, South Carolina,Beaufort County,45013,2010,162233,116606,142666,19567
2000, South Carolina,Beaufort County,45013,2000,120937,85451,112729,8208
2020, South Carolina,Berkeley County,45015,2020,229861,141465,209533,20328
2000, South Carolina,Berkeley County,45015,2000,142651,96997,138716,3935
2010, South Carolina,Berkeley County,45015,2010,177843,118232,167088,10755
2000, South Carolina,Pickens County,45077,2000,110757,99978,108878,1879
2020, South Carolina,Pickens County,45077,2020,131404,108696,124832,6572
2010, South Carolina,Pickens County,45077,2010,119224,105747,115481,3743
2020, South Carolina,Beaufort County,45013,2020,187117,130860,163706,23411
2000, South Carolina,Chesterfield County,45025,2000,42768,27515,41797,971
2020, South Carolina,Chester County,45023,2020,32294,18759,31499,795
2010, South Carolina,Anderson County,45007,2010,187126,149818,181679,5447
2020, South Carolina,Clarendon County,45027,2020,31144,15481,30237,907
2010, South Carolina,Saluda County,45081,2010,19875,12141,17018,2857
2000, South Carolina,Saluda County,45081,2000,19181,12622,17780,1401
2020, South Carolina,Anderson County,45007,2020,203718,154385,194144,9574
2010, South Carolina,Clarendon County,45027,2010,34971,16445,34072,899
2010, South Carolina,Colleton County,45029,2010,38892,22173,37798,1094
2000, South Carolina,Clarendon County,45027,2000,32502,14602,31942,560
2020, South Carolina,Colleton County,45029,2020,38604,22066,37224,1380
2000, South Carolina,Colleton County,45029,2000,38264,21245,37713,551
2000, South Carolina,Allendale County,45005,2000,11211,3068,11030,181
2010, South Carolina,Allendale County,45005,2010,10419,2465,10180,239
2020, South Carolina,Allendale County,45005,2020,8039,2010,7845,194
2020, South Carolina,Darlington County,45031,2020,62905,34103,61509,1396
2000, South Carolina,Darlington County,45031,2000,67394,38402,66736,658
2000, South Carolina,Anderson County,45007,2000,165740,135177,163908,1832
2020, South Carolina,Saluda County,45081,2020,18862,11670,15850,3012
2000, South Carolina,Abbeville County,45001,2000,26167,17881,25950,217
2010, South Carolina,Chesterfield County,45025,2010,46734,29352,45068,1666
2010, South Carolina,Newberry County,45071,2010,37508,23301,34818,2690
2020, South Carolina,Newberry County,45071,2020,37719,23263,34414,3305
2020, South Carolina,Chesterfield County,45025,2020,43273,26188,41187,2086
2000, South Carolina,Newberry County,45071,2000,36108,23115,34575,1533
2010, South Dakota,Turner County,46125,2010,8347,8136,8235,112
2000, South Dakota,Shannon County,46113,2000,12466,562,12289,177
2010, South Dakota,Sanborn County,46111,2010,2355,2307,2327,28
2020, South Dakota,Spink County,46115,2020,6361,6024,6218,143
2010, South Dakota,Spink County,46115,2010,6415,6230,6344,71
2020, South Dakota,Stanley County,46117,2020,2980,2568,2949,31
2000, South Dakota,Stanley County,46117,2000,2772,2579,2760,12
2000, South Dakota,Spink County,46115,2000,7454,7272,7425,29
2000, South Dakota,Sanborn County,46111,2000,2675,2645,2648,27
2000, South Dakota,Walworth County,46129,2000,5974,5172,5938,36
2020, South Dakota,Walworth County,46129,2020,5315,4140,5216,99
2010, South Dakota,Walworth County,46129,2010,5438,4494,5399,39
2010, South Dakota,Ziebach County,46137,2010,2801,610,2714,87
2020, South Dakota,Todd County,46121,2020,9319,710,9097,222
2010, South Dakota,Shannon County,46113,2010,13586,397,13288,298
2010, South Dakota,Stanley County,46117,2010,2966,2670,2945,21
2010, South Dakota,Union County,46127,2010,14399,13758,14094,305
2020, South Dakota,Union County,46127,2020,16811,15131,16150,661
2000, South Dakota,Roberts County,46109,2000,10016,6840,9953,63
2000, South Dakota,Turner County,46125,2000,8849,8748,8813,36
2020, South Dakota,Turner County,46125,2020,8673,8109,8424,249
2000, South Dakota,Tripp County,46123,2000,6430,5625,6375,55
2020, South Dakota,Tripp County,46123,2020,5624,4325,5570,54
2010, South Dakota,Tripp County,46123,2010,5644,4689,5584,60
2000, South Dakota,Sully County,46119,2000,1556,1522,1544,12
2010, South Dakota,Yankton County,46135,2010,22438,20829,21824,614
2010, South Dakota,Todd County,46121,2010,9612,921,9385,227
2000, South Dakota,Yankton County,46135,2000,21652,20592,21257,395
2020, South Dakota,Sully County,46119,2020,1446,1350,1404,42
2010, South Dakota,Sully County,46119,2010,1373,1326,1361,12
2000, South Dakota,Todd County,46121,2000,9050,1138,8912,138
2020, South Dakota,Sanborn County,46111,2020,2330,2186,2273,57
2010, South Dakota,Roberts County,46109,2010,10149,6265,10023,126
2020, South Dakota,Roberts County,46109,2020,10280,5605,10065,215
2000, South Dakota,Union County,46127,2000,12584,12187,12426,158
2020, South Dakota,Yankton County,46135,2020,23310,20573,22076,1234
2010, South Dakota,Lake County,46079,2010,11200,10771,11025,175
2000, South Dakota,Ziebach County,46137,2000,2519,665,2494,25
2000, South Dakota,Hand County,46059,2000,3741,3715,3730,11
2010, South Dakota,Hand County,46059,2010,3431,3377,3412,19
2020, South Dakota,Hand County,46059,2020,3145,3006,3096,49
2020, South Dakota,Charles Mix County,46023,2020,9373,5751,9145,228
2010, South Dakota,Charles Mix County,46023,2010,9129,5930,8977,152
2000, South Dakota,Charles Mix County,46023,2000,9350,6512,9173,177
2020, South Dakota,Hamlin County,46057,2020,6164,5727,5876,288
2000, South Dakota,Clark County,46025,2000,4143,4087,4123,20
2020, South Dakota,Clark County,46025,2020,3837,3617,3668,169
2010, South Dakota,Clark County,46025,2010,3691,3620,3628,63
2000, South Dakota,Clay County,46027,2000,13537,12560,13417,120
2020, South Dakota,Clay County,46027,2020,14967,12809,14509,458
2010, South Dakota,Clay County,46027,2010,13864,12637,13587,277
2020, South Dakota,Oglala Lakota County,46102,2020,13672,446,13270,402
2000, South Dakota,Hamlin County,46057,2000,5540,5456,5505,35
2010, South Dakota,Codington County,46029,2010,27227,25951,26794,433
2000, South Dakota,Codington County,46029,2000,25897,25054,25623,274
2020, South Dakota,Lake County,46079,2020,11059,10138,10453,606
2000, South Dakota,Lake County,46079,2000,11276,11023,11187,89
2020, South Dakota,Ziebach County,46137,2020,2413,407,2379,34
2000, South Dakota,Haakon County,46055,2000,2196,2117,2183,13
2010, South Dakota,Haakon County,46055,2010,1937,1834,1920,17
2020, South Dakota,Haakon County,46055,2020,1872,1720,1853,19
2000, South Dakota,Corson County,46031,2000,4181,1555,4092,89
2010, South Dakota,Corson County,46031,2010,4050,1204,3944,106
2020, South Dakota,Corson County,46031,2020,3902,957,3856,46
2020, South Dakota,Moody County,46101,2020,6336,4847,6022,314
2000, South Dakota,Moody County,46101,2000,6595,5600,6545,50
2020, South Dakota,Codington County,46029,2020,28325,26091,27586,739
2010, South Dakota,Moody County,46101,2010,6486,5256,6375,111
2000, South Dakota,Hanson County,46061,2000,3139,3124,3136,3
2010, South Dakota,Hanson County,46061,2010,3331,3285,3316,15
2020, South Dakota,Perkins County,46105,2020,2835,2659,2797,38
2010, South Dakota,Brookings County,46011,2010,31965,29802,31329,636
2020, South Dakota,Brookings County,46011,2020,34375,30291,32948,1427
2000, South Dakota,Brookings County,46011,2000,28220,27194,27973,247
2000, South Dakota,Pennington County,46103,2000,88565,76789,86224,2341
2010, South Dakota,Pennington County,46103,2010,100948,84350,96904,4044
2020, South Dakota,Pennington County,46103,2020,109222,84558,103647,5575
2020, South Dakota,Brown County,46013,2020,38301,33096,36642,1659
2010, South Dakota,Brown County,46013,2010,36531,34057,36035,496
2000, South Dakota,Brown County,46013,2000,35460,33854,35223,237
2020, South Dakota,Brule County,46015,2020,5247,4365,5141,106
2000, South Dakota,Brule County,46015,2000,5364,4823,5338,26
2010, South Dakota,Brule County,46015,2010,5255,4646,5180,75
2020, South Dakota,Hanson County,46061,2020,3461,3330,3428,33
2020, South Dakota,Buffalo County,46017,2020,1948,286,1935,13
2000, South Dakota,Buffalo County,46017,2000,2032,332,2014,18
2010, South Dakota,Butte County,46019,2010,10110,9526,9804,306
2000, South Dakota,Butte County,46019,2000,9094,8687,8828,266
2020, South Dakota,Butte County,46019,2020,10243,9319,9833,410
2000, South Dakota,Harding County,46063,2000,1353,1321,1331,22
2020, South Dakota,Harding County,46063,2020,1311,1214,1279,32
2010, South Dakota,Harding County,46063,2010,1255,1204,1235,20
2000, South Dakota,Kingsbury County,46077,2000,5815,5730,5775,40
2010, South Dakota,Kingsbury County,46077,2010,5148,5048,5076,72
2020, South Dakota,Kingsbury County,46077,2020,5187,4964,5068,119
2000, South Dakota,Campbell County,46021,2000,1782,1770,1778,4
2010, South Dakota,Campbell County,46021,2010,1466,1441,1446,20
2020, South Dakota,Campbell County,46021,2020,1377,1282,1340,37
2010, South Dakota,Buffalo County,46017,2010,1912,283,1877,35
2010, South Dakota,Gregory County,46053,2010,4271,3828,4233,38
2000, South Dakota,Gregory County,46053,2000,4792,4465,4751,41
2020, South Dakota,Gregory County,46053,2020,3994,3504,3942,52
2010, South Dakota,Meade County,46093,2010,25434,23405,24661,773
2000, South Dakota,McPherson County,46089,2000,2904,2885,2898,6
2010, South Dakota,McPherson County,46089,2010,2459,2414,2434,25
2020, South Dakota,McPherson County,46089,2020,2411,2275,2358,53
2010, South Dakota,Douglas County,46043,2010,3002,2899,2979,23
2020, South Dakota,Douglas County,46043,2020,2835,2664,2781,54
2000, South Dakota,Douglas County,46043,2000,3458,3391,3445,13
2000, South Dakota,McCook County,46087,2000,5832,5766,5787,45
2020, South Dakota,McCook County,46087,2020,5682,5320,5507,175
2010, South Dakota,McCook County,46087,2010,5618,5507,5519,99
2010, South Dakota,Lincoln County,46083,2010,44828,43068,44275,553
2000, South Dakota,Lincoln County,46083,2000,24131,23539,23962,169
2020, South Dakota,Lincoln County,46083,2020,65161,58994,63482,1679
2000, South Dakota,Meade County,46093,2000,24253,22471,23744,509
2010, South Dakota,Edmunds County,46045,2010,4071,3981,4013,58
2020, South Dakota,Edmunds County,46045,2020,3986,3802,3925,61
2010, South Dakota,Marshall County,46091,2010,4656,3974,4339,317
2020, South Dakota,Marshall County,46091,2020,4306,3628,4051,255
2000, South Dakota,Marshall County,46091,2000,4576,4237,4541,35
2000, South Dakota,Fall River County,46047,2000,7453,6746,7323,130
2010, South Dakota,Fall River County,46047,2010,7094,6287,6935,159
2020, South Dakota,Fall River County,46047,2020,6973,5992,6793,180
2020, South Dakota,Faulk County,46049,2020,2125,2014,2079,46
2000, South Dakota,Faulk County,46049,2000,2640,2626,2634,6
2010, South Dakota,Faulk County,46049,2010,2364,2339,2346,18
2000, South Dakota,Lyman County,46085,2000,3895,2522,3877,18
2020, South Dakota,Lyman County,46085,2020,3718,1919,3673,45
2010, South Dakota,Lyman County,46085,2010,3755,2191,3713,42
2000, South Dakota,Edmunds County,46045,2000,4367,4332,4346,21
2020, South Dakota,Meade County,46093,2020,29852,25727,28551,1301
2020, South Dakota,Jackson County,46071,2020,2806,1049,2745,61
2010, South Dakota,Dewey County,46041,2010,5301,1115,5203,98
2010, South Dakota,Custer County,46033,2010,8216,7737,8034,182
2020, South Dakota,Custer County,46033,2020,8318,7585,8107,211
2000, South Dakota,Custer County,46033,2000,7275,6851,7165,110
2010, South Dakota,Minnehaha County,46099,2010,169468,149220,162486,6982
2020, South Dakota,Minnehaha County,46099,2020,197214,158352,185180,12034
2000, South Dakota,Minnehaha County,46099,2000,148281,137941,145094,3187
2020, South Dakota,Lawrence County,46081,2020,25768,23319,24846,922
2010, South Dakota,Lawrence County,46081,2010,24097,22747,23485,612
2000, South Dakota,Lawrence County,46081,2000,21802,20884,21406,396
2010, South Dakota,Miner County,46097,2010,2389,2337,2358,31
2020, South Dakota,Miner County,46097,2020,2298,2186,2256,42
2000, South Dakota,Miner County,46097,2000,2884,2848,2866,18
2000, South Dakota,Davison County,46035,2000,18741,18034,18611,130
2010, South Dakota,Davison County,46035,2010,19504,18421,19210,294
2020, South Dakota,Davison County,46035,2020,19956,17790,19043,913
2000, South Dakota,Day County,46037,2000,6267,5719,6243,24
2020, South Dakota,Day County,46037,2020,5449,4627,5296,153
2010, South Dakota,Day County,46037,2010,5710,5030,5648,62
2020, South Dakota,Grant County,46051,2020,7556,6846,7076,480
2010, South Dakota,Grant County,46051,2010,7356,7146,7188,168
2000, South Dakota,Mellette County,46095,2000,2083,932,2048,35
2010, South Dakota,Mellette County,46095,2010,2048,814,2018,30
2000, South Dakota,Grant County,46051,2000,7847,7738,7804,43
2010, South Dakota,Deuel County,46039,2010,4364,4253,4278,86
2020, South Dakota,Mellette County,46095,2020,1918,655,1879,39
2020, South Dakota,Deuel County,46039,2020,4295,4068,4158,137
2000, South Dakota,Deuel County,46039,2000,4498,4431,4464,34
2000, South Dakota,Dewey County,46041,2000,5972,1442,5921,51
2020, South Dakota,Dewey County,46041,2020,5239,855,5158,81
2010, South Dakota,Perkins County,46105,2010,2982,2890,2962,20
2000, South Dakota,Perkins County,46105,2000,3363,3250,3338,25
2010, South Dakota,Hamlin County,46057,2010,5903,5706,5754,149
2010, South Dakota,Hughes County,46065,2010,17022,14593,16716,306
2000, South Dakota,Hyde County,46069,2000,1671,1522,1663,8
2010, South Dakota,Hyde County,46069,2010,1420,1265,1405,15
2010, South Dakota,Jones County,46075,2010,1006,962,993,13
2020, South Dakota,Hyde County,46069,2020,1262,1092,1238,24
2010, South Dakota,Beadle County,46005,2010,17398,15599,16061,1337
2020, South Dakota,Hughes County,46065,2020,17765,14232,17275,490
2020, South Dakota,Jones County,46075,2020,917,777,906,11
2010, South Dakota,Bon Homme County,46009,2010,7070,6349,6940,130
2000, South Dakota,Bon Homme County,46009,2000,7260,6934,7218,42
2020, South Dakota,Aurora County,46003,2020,2747,2443,2528,219
2020, South Dakota,Jerauld County,46073,2020,1663,1557,1589,74
2000, South Dakota,Jones County,46075,2000,1193,1143,1189,4
2000, South Dakota,Beadle County,46005,2000,17023,16501,16868,155
2000, South Dakota,Hughes County,46065,2000,16481,14654,16280,201
2010, South Dakota,Hutchinson County,46067,2010,7343,7151,7223,120
2010, South Dakota,Aurora County,46003,2010,2710,2577,2609,101
2020, South Dakota,Hutchinson County,46067,2020,7427,7068,7270,157
2000, South Dakota,Bennett County,46007,2000,3574,1462,3502,72
2010, South Dakota,Jerauld County,46073,2010,2071,2009,1987,84
2000, South Dakota,Aurora County,46003,2000,3058,2926,2994,64
2020, South Dakota,Bon Homme County,46009,2020,7003,6194,6886,117
2000, South Dakota,Jerauld County,46073,2000,2295,2272,2288,7
2000, South Dakota,Hutchinson County,46067,2000,8075,7980,8033,42
2000, South Dakota,Jackson County,46071,2000,2930,1467,2918,12
2010, South Dakota,Potter County,46107,2010,2329,2272,2312,17
2000, South Dakota,Potter County,46107,2000,2693,2643,2688,5
2020, South Dakota,Potter County,46107,2020,2472,2329,2433,39
2010, South Dakota,Bennett County,46007,2010,3431,1157,3364,67
2020, South Dakota,Bennett County,46007,2020,3381,1011,3294,87
2010, South Dakota,Jackson County,46071,2010,3031,1295,2993,38
2020, South Dakota,Beadle County,46005,2020,19149,13861,16408,2741
2010, Tennessee,Davidson County,47037,2010,626681,385039,565564,61117
2000, Tennessee,Humphreys County,47085,2000,17929,17125,17781,148
2020, Tennessee,Lawrence County,47099,2020,44159,40717,43042,1117
2020, Tennessee,Davidson County,47037,2020,715884,400622,617765,98119
2000, Tennessee,Davidson County,47037,2000,569891,381783,543800,26091
2000, Tennessee,Lawrence County,47099,2000,39926,38660,39527,399
2000, Tennessee,Rhea County,47143,2000,28400,27097,27926,474
2000, Tennessee,Williamson County,47187,2000,126638,115941,123441,3197
2020, Tennessee,Rhea County,47143,2020,32870,28987,30910,1960
2020, Tennessee,Meigs County,47121,2020,12758,11894,12538,220
2010, Tennessee,Putnam County,47141,2010,72321,66536,68463,3858
2000, Tennessee,Putnam County,47141,2000,62315,58903,60424,1891
2020, Tennessee,Lewis County,47101,2020,12582,11654,12256,326
2020, Tennessee,Putnam County,47141,2020,79854,67940,73598,6256
2010, Tennessee,Lewis County,47101,2010,12161,11656,11940,221
2010, Tennessee,Rhea County,47143,2010,31809,29695,30622,1187
2000, Tennessee,Lewis County,47101,2000,11367,11034,11231,136
2010, Tennessee,Decatur County,47039,2010,11757,11139,11449,308
2010, Tennessee,Lawrence County,47099,2010,41869,40050,41180,689
2020, Tennessee,Decatur County,47039,2020,11435,10565,11077,358
2000, Tennessee,DeKalb County,47041,2000,17423,16653,16790,633
2020, Tennessee,DeKalb County,47041,2020,20080,17763,18631,1449
2010, Tennessee,DeKalb County,47041,2010,18723,17352,17484,1239
2020, Tennessee,Humphreys County,47085,2020,18990,17270,18541,449
2000, Tennessee,Decatur County,47039,2000,11731,11041,11502,229
2010, Tennessee,Greene County,47059,2010,68831,65358,67141,1690
2000, Tennessee,Lauderdale County,47097,2000,27101,17295,26787,314
2000, Tennessee,Smith County,47159,2000,17712,16900,17512,200
2010, Tennessee,Smith County,47159,2010,19166,18179,18749,417
2020, Tennessee,Smith County,47159,2020,19904,18192,19386,518
2010, Tennessee,Moore County,47127,2010,6362,6068,6292,70
2020, Tennessee,Moore County,47127,2020,6461,6030,6360,101
2000, Tennessee,Grundy County,47061,2000,14332,14093,14191,141
2000, Tennessee,Morgan County,47129,2000,19757,19109,19637,120
2010, Tennessee,Morgan County,47129,2010,21987,20761,21799,188
2010, Tennessee,Grundy County,47061,2010,13703,13394,13590,113
2020, Tennessee,Morgan County,47129,2020,21035,19130,20736,299
2010, Tennessee,Warren County,47177,2010,39839,35650,36615,3224
2000, Tennessee,Warren County,47177,2000,38276,35083,36391,1885
2000, Tennessee,Houston County,47083,2000,8088,7650,7987,101
2000, Tennessee,Hamblen County,47063,2000,58128,52732,54829,3299
2020, Tennessee,Hamblen County,47063,2020,64499,51243,55016,9483
2010, Tennessee,Lake County,47095,2010,7832,5490,7696,136
2000, Tennessee,Lake County,47095,2000,7954,5300,7845,109
2020, Tennessee,Lake County,47095,2020,7005,4825,6830,175
2020, Tennessee,Warren County,47177,2020,40953,34794,37010,3943
2020, Tennessee,Grundy County,47061,2020,13529,12671,13354,175
2000, Tennessee,Moore County,47127,2000,5740,5501,5695,45
2000, Tennessee,Bedford County,47003,2000,37586,32640,34775,2811
2010, Tennessee,Lauderdale County,47097,2010,27815,17236,27251,564
2020, Tennessee,Lauderdale County,47097,2020,25143,15144,24556,587
2010, Tennessee,Meigs County,47121,2010,11753,11341,11577,176
2020, Tennessee,Greene County,47059,2020,70152,63841,67617,2535
2000, Tennessee,Monroe County,47123,2000,38961,36962,38277,684
2020, Tennessee,Monroe County,47123,2020,46250,41678,44313,1937
2010, Tennessee,Monroe County,47123,2010,44519,41661,43071,1448
2000, Tennessee,Cumberland County,47035,2000,46802,45917,46224,578
2020, Tennessee,Cumberland County,47035,2020,61145,56870,59209,1936
2010, Tennessee,Cumberland County,47035,2010,56053,54266,54746,1307
2010, Tennessee,Bedford County,47003,2010,45058,36848,39975,5083
2010, Tennessee,Montgomery County,47125,2010,172331,122336,158579,13752
2000, Tennessee,Montgomery County,47125,2000,134768,98611,127808,6960
2020, Tennessee,Montgomery County,47125,2020,220069,137775,197135,22934
2000, Tennessee,Crockett County,47033,2000,14532,11910,13739,793
2010, Tennessee,Crockett County,47033,2010,14586,11478,13312,1274
2020, Tennessee,Crockett County,47033,2020,13911,10240,12413,1498
2010, Tennessee,Williamson County,47187,2010,183182,163728,175016,8166
2020, Tennessee,Bedford County,47003,2020,50237,37996,42572,7665
2000, Tennessee,Greene County,47059,2000,62909,60659,62268,641
2010, Tennessee,Humphreys County,47085,2010,18538,17629,18260,278
2010, Tennessee,Tipton County,47167,2010,61081,47501,59812,1269
2000, Tennessee,Jefferson County,47089,2000,44294,42370,43706,588
2020, Tennessee,Sevier County,47155,2020,98380,85656,89766,8614
2000, Tennessee,Sevier County,47155,2000,71170,69230,70286,884
2010, Tennessee,Sevier County,47155,2010,89889,84217,85102,4787
2020, Tennessee,Jackson County,47087,2020,11617,10863,11372,245
2000, Tennessee,Jackson County,47087,2000,10984,10834,10895,89
2000, Tennessee,Shelby County,47157,2000,897472,424834,874108,23364
2010, Tennessee,Shelby County,47157,2010,927644,376270,875552,52092
2010, Tennessee,Sequatchie County,47153,2010,14112,13543,13650,462
2010, Tennessee,Fayette County,47047,2010,38413,26578,37555,858
2020, Tennessee,Sequatchie County,47153,2020,15826,14585,15205,621
2020, Tennessee,Shelby County,47157,2020,929744,326077,852037,77707
2010, Tennessee,Union County,47173,2010,19109,18678,18860,249
2020, Tennessee,Union County,47173,2020,19802,18770,19398,404
2010, Tennessee,Marion County,47115,2010,28237,26501,27876,361
2020, Tennessee,Marion County,47115,2020,28837,25872,28236,601
2000, Tennessee,Marion County,47115,2000,27776,26201,27574,202
2000, Tennessee,Union County,47173,2000,17808,17534,17668,140
2010, Tennessee,Marshall County,47117,2010,30617,27094,29231,1386
2000, Tennessee,Sequatchie County,47153,2000,11370,11218,11277,93
2020, Tennessee,Fayette County,47047,2020,41990,27857,40560,1430
2000, Tennessee,Fayette County,47047,2000,28806,17997,28508,298
2010, Tennessee,Fentress County,47049,2010,17959,17623,17770,189
2000, Tennessee,Franklin County,47051,2000,39270,36206,38650,620
2020, Tennessee,Trousdale County,47169,2020,11615,8883,11240,375
2010, Tennessee,Trousdale County,47169,2010,7870,6852,7672,198
2000, Tennessee,Trousdale County,47169,2000,7259,6284,7149,110
2000, Tennessee,Loudon County,47105,2000,39086,37482,38192,894
2010, Tennessee,Loudon County,47105,2010,48556,45339,45161,3395
2010, Tennessee,Jackson County,47087,2010,11638,11387,11474,164
2020, Tennessee,Loudon County,47105,2020,54886,47353,49530,5356
2000, Tennessee,Unicoi County,47171,2000,17667,17307,17325,342
2020, Tennessee,Unicoi County,47171,2020,17928,16386,16821,1107
2010, Tennessee,Macon County,47111,2010,22248,21364,21329,919
2020, Tennessee,Macon County,47111,2020,25216,22795,23532,1684
2000, Tennessee,Macon County,47111,2000,20386,19949,20037,349
2010, Tennessee,Madison County,47113,2010,98294,58226,94988,3306
2010, Tennessee,Unicoi County,47171,2010,18313,17553,17619,694
2020, Tennessee,Fentress County,47049,2020,18489,17633,18173,316
2000, Tennessee,Fentress County,47049,2000,16625,16499,16535,90
2000, Tennessee,Madison County,47113,2000,91837,59877,90265,1572
2020, Tennessee,Madison County,47113,2020,98823,54249,94101,4722
2000, Tennessee,Gibson County,47053,2000,48152,37878,47612,540
2010, Tennessee,Jefferson County,47089,2010,51407,48571,49788,1619
2010, Tennessee,Gibson County,47053,2010,49683,38988,48671,1012
2000, Tennessee,Marshall County,47117,2000,26767,23935,26000,767
2020, Tennessee,Stewart County,47161,2020,13657,12463,13321,336
2010, Tennessee,Stewart County,47161,2010,13324,12605,13074,250
2020, Tennessee,Grainger County,47057,2020,23527,21934,22754,773
2010, Tennessee,Grainger County,47057,2010,22657,21978,22127,530
2000, Tennessee,Grainger County,47057,2000,20659,20330,20433,226
2020, Tennessee,McMinn County,47107,2020,53276,46564,51115,2161
2000, Tennessee,McMinn County,47107,2000,49015,45445,48131,884
2010, Tennessee,McMinn County,47107,2010,52266,47954,50784,1482
2000, Tennessee,Van Buren County,47175,2000,5508,5454,5490,18
2020, Tennessee,Dickson County,47043,2020,54315,47609,51733,2582
2000, Tennessee,McNairy County,47109,2000,24653,22734,24424,229
2010, Tennessee,McNairy County,47109,2010,26075,23925,25679,396
2020, Tennessee,McNairy County,47109,2020,25866,22983,25428,438
2010, Tennessee,Dickson County,47043,2010,49666,45611,48093,1573
2000, Tennessee,Tipton County,47167,2000,51271,39920,50649,622
2020, Tennessee,Tipton County,47167,2020,60970,45400,59284,1686
2020, Tennessee,Jefferson County,47089,2020,54683,49561,52291,2392
2000, Tennessee,Meigs County,47121,2000,11086,10826,11023,63
2000, Tennessee,Dickson County,47043,2000,43156,40243,42672,484
2000, Tennessee,Maury County,47119,2000,69498,57262,67234,2264
2010, Tennessee,Maury County,47119,2010,80956,66677,77047,3909
2020, Tennessee,Maury County,47119,2020,100974,77837,93314,7660
2020, Tennessee,Marshall County,47117,2020,34318,28704,32083,2235
2000, Tennessee,Giles County,47055,2000,29447,25454,29181,266
2020, Tennessee,Giles County,47055,2020,30346,25170,29618,728
2010, Tennessee,Giles County,47055,2010,29485,25480,29014,471
2020, Tennessee,Scott County,47151,2020,21850,21051,21645,205
2000, Tennessee,Scott County,47151,2000,21127,20817,21007,120
2010, Tennessee,Scott County,47151,2010,22228,21853,22108,120
2010, Tennessee,Anderson County,47001,2010,75129,69065,73361,1768
2000, Tennessee,Anderson County,47001,2000,71330,66593,70543,787
2020, Tennessee,Anderson County,47001,2020,77123,66863,74303,2820
2020, Tennessee,Lincoln County,47103,2020,35319,30195,34051,1268
2000, Tennessee,Lincoln County,47103,2000,31340,28289,31019,321
2010, Tennessee,Lincoln County,47103,2010,33361,29841,32476,885
2000, Tennessee,Stewart County,47161,2000,12370,11785,12246,124
2000, Tennessee,Dyer County,47045,2000,37279,31835,36845,434
2010, Tennessee,Dyer County,47045,2010,38335,31432,37333,1002
2020, Tennessee,Dyer County,47045,2020,36801,28611,35498,1303
2010, Tennessee,Van Buren County,47175,2010,5548,5441,5498,50
2020, Tennessee,Van Buren County,47175,2020,6168,5890,6085,83
2020, Tennessee,Gibson County,47053,2020,50429,38280,48990,1439
2000, Tennessee,Benton County,47005,2000,16537,15948,16380,157
2020, Tennessee,Franklin County,47051,2020,42774,37256,41272,1502
2020, Tennessee,Hardin County,47071,2020,26831,24468,26266,565
2010, Tennessee,Carroll County,47017,2010,28522,24755,27927,595
2000, Tennessee,Carroll County,47017,2000,29475,25843,29089,386
2020, Tennessee,Carroll County,47017,2020,28440,23997,27671,769
2010, Tennessee,Hardeman County,47069,2010,27253,15379,26877,376
2020, Tennessee,Haywood County,47075,2020,17864,7695,17026,838
2010, Tennessee,Haywood County,47075,2010,18787,8617,18064,723
2000, Tennessee,Hardeman County,47069,2000,28105,16116,27832,273
2020, Tennessee,Blount County,47009,2020,135280,119367,129571,5709
2010, Tennessee,Carter County,47019,2010,57424,55335,56534,890
2000, Tennessee,Carter County,47019,2000,56742,55316,56238,504
2020, Tennessee,Carter County,47019,2020,56356,52173,55175,1181
2020, Tennessee,Bledsoe County,47007,2020,14913,13258,14454,459
2010, Tennessee,Bledsoe County,47007,2010,12876,12048,12621,255
2000, Tennessee,Bledsoe County,47007,2000,12367,11680,12229,138
2010, Tennessee,Rutherford County,47149,2010,262604,205417,245104,17500
2020, Tennessee,Hickman County,47081,2020,24925,22351,24244,681
2020, Tennessee,Rutherford County,47149,2020,341486,226227,303169,38317
2020, Tennessee,Cheatham County,47021,2020,41072,36788,39233,1839
2010, Tennessee,Cheatham County,47021,2010,39105,37374,38195,910
2010, Tennessee,Obion County,47131,2010,31807,27329,30808,999
2000, Tennessee,Obion County,47131,2000,32450,28607,31834,616
2000, Tennessee,Cheatham County,47021,2000,35912,34783,35475,437
2020, Tennessee,Perry County,47135,2020,8366,7748,8239,127
2000, Tennessee,Wayne County,47181,2000,16842,15482,16700,142
2010, Tennessee,Perry County,47135,2010,7915,7584,7784,131
2010, Tennessee,Roane County,47145,2010,54181,51157,53471,710
2020, Tennessee,Knox County,47093,2020,478971,379510,450403,28568
2020, Tennessee,Roane County,47145,2020,53404,48463,52393,1011
2000, Tennessee,Roane County,47145,2000,51910,49440,51551,359
2000, Tennessee,Haywood County,47075,2000,19797,9252,19273,524
2000, Tennessee,Rutherford County,47149,2000,182023,156050,176958,5065
2000, Tennessee,Perry County,47135,2000,7631,7368,7570,61
2010, Tennessee,Knox County,47093,2010,432226,369794,417214,15012
2010, Tennessee,Wayne County,47181,2010,17021,15712,16744,277
2010, Tennessee,Weakley County,47183,2010,35021,31124,34321,700
2000, Tennessee,White County,47185,2000,23102,22323,22863,239
2010, Tennessee,White County,47185,2010,25841,24739,25416,425
2020, Tennessee,White County,47185,2020,27351,25018,26615,736
2010, Tennessee,Wilson County,47189,2010,113993,101379,110302,3691
2020, Tennessee,Wilson County,47189,2020,147737,120782,139362,8375
2000, Tennessee,Wilson County,47189,2000,88809,81261,87682,1127
2020, Tennessee,Hawkins County,47073,2020,56721,53148,55832,889
2010, Tennessee,Hawkins County,47073,2010,56833,54817,56164,669
2020, Tennessee,Sullivan County,47163,2020,158163,144395,154615,3548
2000, Tennessee,Sullivan County,47163,2000,153048,147771,151958,1090
2000, Tennessee,Hawkins County,47073,2000,53563,52086,53146,417
2010, Tennessee,Sullivan County,47163,2010,156823,149208,154502,2321
2010, Tennessee,Polk County,47139,2010,16825,16397,16592,233
2000, Tennessee,Polk County,47139,2000,16050,15785,15933,117
2010, Tennessee,Overton County,47133,2010,22083,21571,21881,202
2000, Tennessee,Overton County,47133,2000,20118,19834,19980,138
2020, Tennessee,Overton County,47133,2020,22511,21332,22167,344
2000, Tennessee,Weakley County,47183,2000,34895,31501,34493,402
2020, Tennessee,Weakley County,47183,2020,32902,28113,31997,905
2020, Tennessee,Hardeman County,47069,2020,25462,14073,24968,494
2000, Tennessee,Cannon County,47015,2000,12826,12424,12669,157
2020, Tennessee,Cannon County,47015,2020,14506,13187,14111,395
2010, Tennessee,Cannon County,47015,2010,13801,13325,13591,210
2020, Tennessee,Wayne County,47181,2020,16232,14595,15853,379
2010, Tennessee,Campbell County,47013,2010,40716,39778,40244,472
2020, Tennessee,Campbell County,47013,2020,39272,37267,38772,500
2010, Tennessee,Blount County,47009,2010,123010,114993,119569,3441
2000, Tennessee,Blount County,47009,2000,105823,100241,104703,1120
2010, Tennessee,Hardin County,47071,2010,26026,24384,25529,497
2000, Tennessee,Hardin County,47071,2000,25578,24277,25318,260
2020, Tennessee,Polk County,47139,2020,17544,16430,17247,297
2000, Tennessee,Campbell County,47013,2000,39854,39109,39585,269
2020, Tennessee,Obion County,47131,2020,30787,25009,29213,1574
2020, Tennessee,Williamson County,47187,2020,247726,203600,233465,14261
2010, Tennessee,Hancock County,47067,2010,6819,6682,6806,13
2020, Tennessee,Johnson County,47091,2020,17948,16233,17432,516
2010, Tennessee,Johnson County,47091,2010,18244,17544,17975,269
2020, Tennessee,Houston County,47083,2020,8283,7557,8081,202
2010, Tennessee,Houston County,47083,2010,8426,8015,8297,129
2020, Tennessee,Benton County,47005,2020,15864,14487,15489,375
2000, Tennessee,Clay County,47027,2000,7976,7717,7868,108
2010, Tennessee,Clay County,47027,2010,7861,7589,7735,126
2020, Tennessee,Clay County,47027,2020,7581,7247,7451,130
2010, Tennessee,Henry County,47079,2010,32330,28827,31777,553
2000, Tennessee,Knox County,47093,2000,382032,336571,377229,4803
2010, Tennessee,Benton County,47005,2010,16489,15737,16198,291
2020, Tennessee,Henry County,47079,2020,32199,27529,31322,877
2020, Tennessee,Sumner County,47165,2020,196281,158075,183411,12870
2010, Tennessee,Sumner County,47165,2010,160645,142844,154337,6308
2000, Tennessee,Sumner County,47165,2000,130449,119344,128158,2291
2010, Tennessee,Bradley County,47011,2010,98963,89386,94299,4664
2020, Tennessee,Hamilton County,47065,2020,366207,254803,339132,27075
2010, Tennessee,Hamblen County,47063,2010,62544,54163,55833,6711
2000, Tennessee,Hamilton County,47065,2000,307896,235000,302415,5481
2010, Tennessee,Hamilton County,47065,2010,336463,248716,321470,14993
2020, Tennessee,Coffee County,47031,2020,57889,49686,54630,3259
2000, Tennessee,Coffee County,47031,2000,48014,44858,46963,1051
2010, Tennessee,Hickman County,47081,2010,24690,22920,24235,455
2000, Tennessee,Johnson County,47091,2000,17499,16869,17349,150
2010, Tennessee,Coffee County,47031,2010,52796,48561,50789,2007
2000, Tennessee,Hickman County,47081,2000,22295,20893,22073,222
2000, Tennessee,Henry County,47079,2000,31115,27757,30804,311
2020, Tennessee,Bradley County,47011,2020,108620,89555,100159,8461
2020, Tennessee,Cocke County,47029,2020,35999,33028,35045,954
2010, Tennessee,Cocke County,47029,2010,35662,33911,35034,628
2000, Tennessee,Bradley County,47011,2000,87965,81792,86143,1822
2000, Tennessee,Cocke County,47029,2000,33565,32277,33211,354
2000, Tennessee,Claiborne County,47025,2000,29862,29202,29670,192
2010, Tennessee,Franklin County,47051,2010,41052,37260,40023,1029
2000, Tennessee,Pickett County,47137,2000,4945,4903,4904,41
2000, Tennessee,Henderson County,47077,2000,25522,23085,25275,247
2010, Tennessee,Henderson County,47077,2010,27769,24764,27237,532
2010, Tennessee,Claiborne County,47025,2010,32213,31224,31948,265
2000, Tennessee,Robertson County,47147,2000,54433,48518,52986,1447
2010, Tennessee,Robertson County,47147,2010,66283,57919,62380,3903
2020, Tennessee,Robertson County,47147,2020,72803,58467,65925,6878
2020, Tennessee,Hancock County,47067,2020,6662,6391,6622,40
2020, Tennessee,Henderson County,47077,2020,27842,24079,27123,719
2010, Tennessee,Pickett County,47137,2010,5077,4993,5010,67
2020, Tennessee,Pickett County,47137,2020,5001,4829,4918,83
2000, Tennessee,Hancock County,47067,2000,6786,6644,6761,25
2020, Tennessee,Washington County,47179,2020,133001,113998,126865,6136
2020, Tennessee,Claiborne County,47025,2020,32043,30175,31553,490
2000, Tennessee,Washington County,47179,2000,107198,100466,105716,1482
2010, Tennessee,Washington County,47179,2010,122979,112619,119346,3633
2000, Tennessee,Chester County,47023,2000,15540,13696,15390,150
2020, Tennessee,Chester County,47023,2020,17341,14614,16813,528
2010, Tennessee,Chester County,47023,2010,17131,15021,16788,343
2010, Texas,Trinity County,48455,2010,14585,12302,13468,1117
2020, Texas,Hays County,48209,2020,241067,147092,148196,92871
2000, Texas,Hill County,48217,2000,32321,27200,27961,4360
2020, Texas,Franklin County,48159,2020,10359,8138,8904,1455
2000, Texas,Franklin County,48159,2000,9458,8436,8616,842
2020, Texas,Freestone County,48161,2020,19435,13337,16280,3155
2000, Texas,Hemphill County,48211,2000,3351,2937,2829,522
2010, Texas,Frio County,48163,2010,17217,13326,3816,13401
2020, Texas,Irion County,48235,2020,1513,1200,1164,349
2020, Texas,Glasscock County,48173,2020,1116,858,729,387
2010, Texas,Haskell County,48207,2010,5899,4876,4485,1414
2020, Texas,Hemphill County,48211,2020,3382,2372,2245,1137
2010, Texas,Gillespie County,48171,2010,24837,22667,19868,4969
2020, Texas,Gillespie County,48171,2020,26725,21373,20959,5766
2010, Texas,Freestone County,48161,2010,19816,14484,17122,2694
2000, Texas,Gillespie County,48171,2000,20814,19320,17505,3309
2000, Texas,Glasscock County,48173,2000,1406,1090,986,420
2020, Texas,Haskell County,48207,2020,5416,4132,4039,1377
2000, Texas,Haskell County,48207,2000,6093,5044,4844,1249
2000, Texas,Hartley County,48205,2000,5537,4489,4779,758
2020, Texas,Tom Green County,48451,2020,120003,78548,72937,47066
2010, Texas,Glasscock County,48173,2010,1226,1044,848,378
2010, Texas,Franklin County,48159,2010,10605,9178,9272,1333
2020, Texas,Henderson County,48213,2020,82150,64501,70908,11242
2000, Texas,Garza County,48169,2000,4872,3642,3062,1810
2000, Texas,Frio County,48163,2000,16252,11679,4265,11987
2010, Texas,Sterling County,48431,2010,1143,1013,778,365
2010, Texas,Gaines County,48165,2010,17526,14726,11113,6413
2020, Texas,Gaines County,48165,2020,21598,15175,13197,8401
2000, Texas,Galveston County,48167,2000,250158,181830,205219,44939
2000, Texas,Henderson County,48213,2000,73277,64850,68206,5071
2010, Texas,Henderson County,48213,2010,78532,67395,70042,8490
2010, Texas,Jack County,48237,2010,9044,7913,7761,1283
2000, Texas,Jack County,48237,2000,8763,7771,8072,691
2000, Texas,Gaines County,48165,2000,14467,11614,9292,5175
2020, Texas,Frio County,48163,2020,18385,8518,4214,14171
2020, Texas,Hidalgo County,48215,2020,870781,300554,70780,800001
2000, Texas,Trinity County,48455,2000,13779,11540,13111,668
2000, Texas,Hays County,48209,2000,97589,77014,68730,28859
2010, Texas,Hays County,48209,2010,157107,126712,101706,55401
2020, Texas,Trinity County,48455,2020,13602,10833,12288,1314
2000, Texas,Freestone County,48161,2000,17867,13501,16402,1465
2010, Texas,Irion County,48235,2010,1599,1464,1192,407
2010, Texas,Hidalgo County,48215,2010,774769,681649,72563,702206
2000, Texas,Hidalgo County,48215,2000,569463,442525,66363,503100
2010, Texas,Hemphill County,48211,2010,3807,3310,2721,1086
2020, Texas,Galveston County,48167,2020,350682,214512,262046,88636
2010, Texas,Galveston County,48167,2010,291309,211088,226039,65270
2010, Texas,Travis County,48453,2010,1024266,709814,681500,342766
2000, Texas,Travis County,48453,2000,812280,554058,583232,229048
2020, Texas,Travis County,48453,2020,1290188,709447,869078,421110
2010, Texas,Garza County,48169,2010,6461,5348,3415,3046
2020, Texas,Garza County,48169,2020,5816,4325,2544,3272
2000, Texas,Sterling County,48431,2000,1393,1194,961,432
2020, Texas,Sterling County,48431,2020,1372,1064,923,449
2010, Texas,Stephens County,48429,2010,9630,8161,7619,2011
2000, Texas,Irion County,48235,2000,1771,1606,1335,436
2000, Texas,Taylor County,48441,2000,126555,102016,104227,22328
2010, Texas,Hill County,48217,2010,35089,29307,28662,6427
2000, Texas,Grimes County,48185,2000,23552,16909,19765,3787
2010, Texas,Grimes County,48185,2010,26604,19409,20952,5652
2000, Texas,Tarrant County,48439,2000,1446219,1030208,1160929,285290
2010, Texas,Tarrant County,48439,2010,1809034,1205530,1326057,482977
2020, Texas,Tarrant County,48439,2020,2110640,1044549,1489733,620907
2000, Texas,Gregg County,48183,2000,111379,81184,101196,10183
2020, Texas,Gregg County,48183,2020,124239,73043,100199,24040
2010, Texas,Gregg County,48183,2010,121730,81928,101712,20018
2000, Texas,Howard County,48227,2000,33627,26950,21030,12597
2020, Texas,Hopkins County,48223,2020,36787,27514,30303,6484
2000, Texas,Hopkins County,48223,2000,31960,27200,28993,2967
2000, Texas,Hudspeth County,48229,2000,3344,2917,835,2509
2000, Texas,Hood County,48221,2000,41100,38952,38125,2975
2000, Texas,Throckmorton County,48447,2000,1850,1704,1677,173
2010, Texas,Throckmorton County,48447,2010,1641,1555,1489,152
2020, Texas,Hudspeth County,48229,2020,3202,1874,1166,2036
2010, Texas,Hudspeth County,48229,2010,3476,2738,708,2768
2010, Texas,Hood County,48221,2010,51182,47378,45948,5234
2020, Texas,Hood County,48221,2020,61598,51678,53640,7958
2010, Texas,Stonewall County,48433,2010,1490,1306,1281,209
2000, Texas,Stonewall County,48433,2000,1693,1494,1494,199
2020, Texas,Terry County,48445,2020,11831,6930,5262,6569
2010, Texas,Terry County,48445,2010,12651,10283,6440,6211
2000, Texas,Terry County,48445,2000,12761,9769,7135,5626
2010, Texas,Hopkins County,48223,2010,35161,28646,29793,5368
2020, Texas,Taylor County,48441,2020,143208,99225,108452,34756
2000, Texas,Reagan County,48383,2000,3326,2150,1680,1646
2020, Texas,Hall County,48191,2020,2825,1896,1875,950
2010, Texas,Hall County,48191,2010,3353,2579,2266,1087
2000, Texas,Hall County,48191,2000,3782,2722,2742,1040
2020, Texas,Hale County,48189,2020,32522,16925,13033,19489
2000, Texas,Hale County,48189,2000,36602,24438,19070,17532
2010, Texas,Hale County,48189,2010,36273,25670,16004,20269
2000, Texas,Houston County,48225,2000,23185,15899,21446,1739
2020, Texas,Hamilton County,48193,2020,8222,7138,7177,1045
2000, Texas,Hansford County,48195,2000,5369,4289,3679,1690
2010, Texas,Hamilton County,48193,2010,8517,7913,7654,863
2010, Texas,Guadalupe County,48187,2010,131533,105017,84644,46889
2000, Texas,Guadalupe County,48187,2000,89023,69122,59462,29561
2020, Texas,Houston County,48225,2020,22066,13430,18995,3071
2000, Texas,Hamilton County,48193,2000,8229,7720,7619,610
2010, Texas,Houston County,48225,2010,23732,15896,21368,2364
2010, Texas,Howard County,48227,2010,35012,25928,21757,13255
2020, Texas,Grimes County,48185,2020,29268,18591,21907,7361
2020, Texas,Howard County,48227,2020,34860,23664,18686,16174
2000, Texas,Terrell County,48443,2000,1081,955,556,525
2020, Texas,Terrell County,48443,2020,760,480,390,370
2020, Texas,Guadalupe County,48187,2020,172706,103127,107473,65233
2020, Texas,Stonewall County,48433,2020,1245,1032,1019,226
2010, Texas,Hansford County,48195,2010,5613,4593,3183,2430
2020, Texas,Hansford County,48195,2020,5285,3248,2670,2615
2000, Texas,Gonzales County,48177,2000,18628,13458,11247,7381
2010, Texas,Gonzales County,48177,2010,19807,14158,10454,9353
2000, Texas,Hutchinson County,48233,2000,23857,20756,20351,3506
2000, Texas,Harris County,48201,2000,3400578,1997123,2280827,1119751
2000, Texas,Hockley County,48219,2000,22716,16897,14257,8459
2020, Texas,Gonzales County,48177,2020,19653,11341,9756,9897
2020, Texas,Hockley County,48219,2020,21537,13760,10913,10624
2020, Texas,Harris County,48201,2020,4731145,1720356,2696436,2034709
2020, Texas,Harrison County,48203,2020,68839,43925,59000,9839
2010, Texas,Goliad County,48175,2010,7210,6035,4748,2462
2010, Texas,Harris County,48201,2010,4092459,2318256,2420919,1671540
2020, Texas,Goliad County,48175,2020,7012,5127,4724,2288
2010, Texas,Harrison County,48203,2010,65631,45020,58377,7254
2010, Texas,Sutton County,48435,2010,4128,3662,1669,2459
2000, Texas,Sutton County,48435,2000,4077,3069,1971,2106
2020, Texas,Sutton County,48435,2020,3372,1959,1279,2093
2010, Texas,Hartley County,48205,2010,6062,5272,4614,1448
2000, Texas,Goliad County,48175,2000,6928,5724,4489,2439
2000, Texas,Tom Green County,48451,2000,104010,82246,72064,31946
2010, Texas,Tom Green County,48451,2010,110224,90069,70909,39315
2020, Texas,Hartley County,48205,2020,5382,3746,3751,1631
2010, Texas,Hockley County,48219,2010,22935,18000,12942,9993
2000, Texas,Harrison County,48203,2000,62110,44313,58794,3316
2020, Texas,Hill County,48217,2020,35874,26070,27990,7884
2000, Texas,Swisher County,48437,2000,8378,6011,5427,2951
2020, Texas,Swisher County,48437,2020,6971,4182,3824,3147
2020, Texas,Throckmorton County,48447,2020,1440,1294,1295,145
2000, Texas,Grayson County,48181,2000,110595,96443,103076,7519
2020, Texas,Grayson County,48181,2020,135543,99852,114675,20868
2010, Texas,Grayson County,48181,2010,120877,101371,107189,13688
2000, Texas,Gray County,48179,2000,22744,18685,19785,2959
2020, Texas,Gray County,48179,2020,21227,14631,14880,6347
2010, Texas,Gray County,48179,2010,22535,18363,17170,5365
2010, Texas,Hardeman County,48197,2010,4139,3538,3250,889
2000, Texas,Hardeman County,48197,2000,4724,4035,4039,685
2020, Texas,Hunt County,48231,2020,99956,70576,80283,19673
2010, Texas,Swisher County,48437,2010,7854,5901,4705,3149
2020, Texas,Hardeman County,48197,2020,3549,2748,2731,818
2010, Texas,Titus County,48449,2010,32334,21848,19535,12799
2010, Texas,Hunt County,48231,2010,86129,70248,74378,11751
2000, Texas,Hunt County,48231,2000,76596,64013,70230,6366
2010, Texas,Taylor County,48441,2010,131506,104409,102432,29074
2010, Texas,Hardin County,48199,2010,54635,49505,52251,2384
2020, Texas,Hardin County,48199,2020,56231,48005,52814,3417
2020, Texas,Hutchinson County,48233,2020,20617,15269,15656,4961
2010, Texas,Hutchinson County,48233,2010,22150,18944,17764,4386
2000, Texas,Hardin County,48199,2000,48073,43677,46850,1223
2000, Texas,Titus County,48449,2000,28118,19724,20158,7960
2020, Texas,Titus County,48449,2020,31247,16188,17567,13680
2010, Texas,Terrell County,48443,2010,984,828,517,467
2000, Texas,Victoria County,48469,2000,84088,62406,51129,32959
2020, Texas,Fort Bend County,48157,2020,822779,282222,624199,198580
2000, Texas,Brooks County,48047,2000,7976,6049,672,7304
2020, Texas,Brooks County,48047,2020,7076,2914,834,6242
2020, Texas,Wilbarger County,48487,2020,12887,8092,9153,3734
2000, Texas,Wilbarger County,48487,2000,14676,11472,11661,3015
2010, Texas,Wilbarger County,48487,2010,13535,10585,10027,3508
2010, Texas,Brooks County,48047,2010,7223,6471,633,6590
2000, Texas,Wichita County,48485,2000,131664,103705,115567,16097
2010, Texas,Wichita County,48485,2010,131500,101331,109641,21859
2020, Texas,Wichita County,48485,2020,129350,86718,103547,25803
2010, Texas,Brown County,48049,2010,38106,32962,30653,7453
2000, Texas,Brown County,48049,2000,37674,32910,31881,5793
2020, Texas,Brown County,48049,2020,38095,29326,29884,8211
2000, Texas,Burleson County,48051,2000,16470,12199,14059,2411
2020, Texas,Burleson County,48051,2020,17642,12152,13930,3712
2010, Texas,Burleson County,48051,2010,17187,13392,14021,3166
2010, Texas,Briscoe County,48045,2010,1637,1433,1226,411
2020, Texas,Briscoe County,48045,2020,1435,1175,1067,368
2000, Texas,Briscoe County,48045,2000,1790,1492,1383,407
2010, Texas,Brewster County,48043,2010,9232,7993,5314,3918
2010, Texas,Williamson County,48491,2010,422679,330191,324645,98034
2000, Texas,Williamson County,48491,2000,249967,205994,206977,42990
2010, Texas,Bowie County,48037,2010,92565,63641,86503,6062
2020, Texas,Bowie County,48037,2020,92893,57482,85291,7602
2000, Texas,Bowie County,48037,2000,89306,65424,85314,3992
2010, Texas,Willacy County,48489,2010,22134,18995,2837,19297
2000, Texas,Willacy County,48489,2000,20082,14132,2873,17209
2000, Texas,Burnet County,48053,2000,34147,30610,29103,5044
2020, Texas,Willacy County,48489,2020,20164,8743,2553,17611
2000, Texas,Brazoria County,48039,2000,241767,186383,186704,55063
2020, Texas,Brazoria County,48039,2020,372031,190232,256829,115202
2010, Texas,Brazos County,48041,2010,194851,142814,149446,45405
2020, Texas,Brazos County,48041,2020,233849,140206,170782,63067
2000, Texas,Brazos County,48041,2000,152415,113479,125162,27253
2000, Texas,Brewster County,48043,2000,8866,7189,4999,3867
2020, Texas,Brewster County,48043,2020,9546,6411,5583,3963
2010, Texas,Brazoria County,48039,2010,313166,219416,226523,86643
2010, Texas,Burnet County,48053,2010,42750,37825,34098,8652
2020, Texas,Wheeler County,48483,2020,4990,3748,3763,1227
2010, Texas,Wheeler County,48483,2010,5410,4469,4066,1344
2000, Texas,Webb County,48479,2000,193117,158670,11047,182070
2010, Texas,Webb County,48479,2010,250304,220201,10651,239653
2020, Texas,Webb County,48479,2020,267114,102723,12760,254354
2000, Texas,Carson County,48065,2000,6516,6113,6058,458
2020, Texas,Carson County,48065,2020,5807,5069,5249,558
2010, Texas,Carson County,48065,2010,6182,5803,5657,525
2010, Texas,Cass County,48067,2010,30464,24079,29411,1053
2010, Texas,Camp County,48063,2010,12401,8402,9753,2648
2000, Texas,Cass County,48067,2000,30438,23801,29912,526
2020, Texas,Castro County,48069,2020,7371,3676,2587,4784
2010, Texas,Castro County,48069,2010,8062,5532,3234,4828
2000, Texas,Castro County,48069,2000,8285,6243,4006,4279
2000, Texas,Chambers County,48071,2000,26031,21315,23221,2810
2020, Texas,Chambers County,48071,2020,46571,32614,35619,10952
2010, Texas,Chambers County,48071,2010,35096,27582,28461,6635
2010, Texas,Cherokee County,48073,2010,50845,36450,40346,10499
2020, Texas,Cass County,48067,2020,28454,21477,27118,1336
2020, Texas,Williamson County,48491,2020,609017,373264,461929,147088
2000, Texas,Camp County,48063,2000,11549,8030,9842,1707
2010, Texas,Cameron County,48061,2010,406220,353423,48473,357747
2000, Texas,Wheeler County,48483,2000,5284,4641,4620,664
2020, Texas,Burnet County,48053,2020,49130,37845,37931,11199
2010, Texas,Wharton County,48481,2010,41280,29793,25835,15445
2020, Texas,Wharton County,48481,2020,41570,22903,24603,16967
2000, Texas,Wharton County,48481,2000,41188,28423,28300,12888
2020, Texas,Caldwell County,48055,2020,45883,23633,20415,25468
2010, Texas,Caldwell County,48055,2010,38066,28865,20144,17922
2020, Texas,Camp County,48063,2020,12464,7448,9242,3222
2000, Texas,Caldwell County,48055,2000,32194,22577,19176,13018
2020, Texas,Calhoun County,48057,2020,20106,11356,10248,9858
2000, Texas,Calhoun County,48057,2000,20647,16112,12199,8448
2000, Texas,Callahan County,48059,2000,12905,12231,12093,812
2010, Texas,Callahan County,48059,2010,13544,12724,12519,1025
2020, Texas,Callahan County,48059,2020,13708,12154,12402,1306
2020, Texas,Cameron County,48061,2020,421017,162707,44337,376680
2000, Texas,Cameron County,48061,2000,335227,269139,52491,282736
2010, Texas,Calhoun County,48057,2010,21381,17432,11459,9922
2000, Texas,Cherokee County,48073,2000,46659,34685,40481,6178
2000, Texas,Bosque County,48035,2000,17204,15613,15100,2104
2010, Texas,Bosque County,48035,2010,18212,16372,15286,2926
2000, Texas,Angelina County,48005,2000,80130,60174,68634,11496
2020, Texas,Aransas County,48007,2020,23830,17996,17672,6158
2000, Texas,Aransas County,48007,2000,22497,19672,17926,4571
2010, Texas,Aransas County,48007,2010,23158,20231,17468,5690
2020, Texas,Archer County,48009,2020,8560,7551,7818,742
2010, Texas,Archer County,48009,2010,9054,8504,8379,675
2000, Texas,Archer County,48009,2000,8854,8459,8423,431
2000, Texas,Armstrong County,48011,2000,2148,2050,2032,116
2020, Texas,Armstrong County,48011,2020,1848,1646,1704,144
2010, Texas,Armstrong County,48011,2010,1901,1774,1777,124
2000, Texas,Atascosa County,48013,2000,38628,28286,16008,22620
2010, Texas,Atascosa County,48013,2010,44911,38130,17126,27785
2020, Texas,Atascosa County,48013,2020,48981,28203,17803,31178
2010, Texas,Austin County,48015,2010,28417,22379,21776,6641
2000, Texas,Austin County,48015,2000,23590,18924,19785,3805
2010, Texas,Angelina County,48005,2010,86771,62537,69626,17145
2020, Texas,Angelina County,48005,2020,86395,54887,66663,19732
2000, Texas,Andrews County,48003,2000,13004,10024,7802,5202
2020, Texas,Andrews County,48003,2020,18610,10909,8210,10400
2020, Texas,Zavala County,48507,2020,9670,4598,726,8944
2010, Texas,Zavala County,48507,2010,11677,10301,716,10961
2000, Texas,Zavala County,48507,2000,11600,7547,1018,10582
2010, Texas,Zapata County,48505,2010,14018,13122,934,13084
2020, Texas,Zapata County,48505,2020,13889,5421,890,12999
2000, Texas,Zapata County,48505,2000,12182,10241,1854,10328
2020, Texas,Young County,48503,2020,17867,14398,14359,3508
2020, Texas,Austin County,48015,2020,30167,20164,22115,8052
2000, Texas,Young County,48503,2000,17943,16325,16037,1906
2020, Texas,Yoakum County,48501,2020,7694,3758,2726,4968
2010, Texas,Yoakum County,48501,2010,7879,5868,3257,4622
2000, Texas,Yoakum County,48501,2000,7322,5171,3959,3363
2020, Texas,Anderson County,48001,2020,57922,34922,46811,11111
2010, Texas,Anderson County,48001,2010,58458,38632,49171,9287
2000, Texas,Anderson County,48001,2000,55109,36617,48404,6705
2010, Texas,Andrews County,48003,2010,14786,11749,7591,7195
2010, Texas,Young County,48503,2010,18550,16748,15505,3045
2010, Texas,Bailey County,48017,2010,7165,5392,2882,4283
2000, Texas,Bailey County,48017,2000,6594,4397,3475,3119
2020, Texas,Bailey County,48017,2020,6904,3348,2364,4540
2000, Texas,Wise County,48497,2000,48793,44407,43545,5248
2010, Texas,Wise County,48497,2010,59127,52448,49015,10112
2020, Texas,Wise County,48497,2020,68632,54054,54938,13694
2020, Texas,Bexar County,48029,2020,2009324,919729,818366,1190958
2000, Texas,Blanco County,48031,2000,8418,7658,7128,1290
2020, Texas,Blanco County,48031,2020,11374,9255,9282,2092
2010, Texas,Blanco County,48031,2010,10497,9475,8588,1909
2010, Texas,Bexar County,48029,2010,1714773,1250252,707815,1006958
2010, Texas,Winkler County,48495,2010,7110,5238,3286,3824
2000, Texas,Winkler County,48495,2000,7173,5366,4017,3156
2020, Texas,Borden County,48033,2020,631,576,545,86
2000, Texas,Borden County,48033,2000,729,660,642,87
2020, Texas,Wilson County,48493,2020,49753,34471,30521,19232
2000, Texas,Wilson County,48493,2000,32408,26311,20574,11834
2010, Texas,Wilson County,48493,2010,42918,38231,26506,16412
2010, Texas,Borden County,48033,2010,641,600,546,95
2020, Texas,Winkler County,48495,2020,7791,4046,3059,4732
2020, Texas,Bosque County,48035,2020,18235,14483,14914,3321
2000, Texas,Bexar County,48029,2000,1392931,959122,635898,757033
2000, Texas,Wood County,48499,2000,36752,32749,34650,2102
2010, Texas,Bandera County,48019,2010,20485,19010,17070,3415
2020, Texas,Bandera County,48019,2020,20851,17110,16841,4010
2000, Texas,Bandera County,48019,2000,17645,16590,15261,2384
2010, Texas,Bastrop County,48021,2010,74171,54750,49981,24190
2000, Texas,Bastrop County,48021,2000,57733,46327,43888,13845
2020, Texas,Bastrop County,48021,2020,97216,55730,55732,41484
2020, Texas,Baylor County,48023,2020,3465,3036,3026,439
2020, Texas,Wood County,48499,2020,44843,36871,39949,4894
2000, Texas,Baylor County,48023,2000,4093,3723,3711,382
2000, Texas,Bee County,48025,2000,32359,21957,14909,17450
2020, Texas,Bee County,48025,2020,31047,15347,11655,19392
2010, Texas,Bee County,48025,2010,31861,25092,13955,17906
2020, Texas,Bell County,48027,2020,370647,180426,277180,93467
2000, Texas,Bell County,48027,2000,237974,150900,198273,39701
2010, Texas,Bell County,48027,2010,310235,190553,243225,67010
2010, Texas,Wood County,48499,2010,41964,37213,38413,3551
2010, Texas,Baylor County,48023,2010,3726,3410,3271,455
2000, Texas,Fort Bend County,48157,2000,354452,201896,279581,74871
2020, Texas,Cherokee County,48073,2020,50412,32134,38615,11797
2020, Texas,Childress County,48075,2020,6664,4427,4722,1942
2000, Texas,Duval County,48131,2000,13120,10525,1576,11544
2020, Texas,Duval County,48131,2020,9831,4994,1869,7962
2010, Texas,Duval County,48131,2010,11782,10247,1358,10424
2000, Texas,Eastland County,48133,2000,18297,16656,16321,1976
2010, Texas,Eastland County,48133,2010,18583,16697,15910,2673
2020, Texas,Eastland County,48133,2020,17725,14677,14791,2934
2010, Texas,Ector County,48135,2010,137130,104653,64799,72331
2020, Texas,Ector County,48135,2020,165171,79965,65120,100051
2000, Texas,Ector County,48135,2000,121123,89257,69817,51306
2010, Texas,Edwards County,48137,2010,2002,1739,975,1027
2020, Texas,Edwards County,48137,2020,1422,961,704,718
2000, Texas,Edwards County,48137,2000,2162,1800,1188,974
2020, Texas,El Paso County,48141,2020,865657,313741,150306,715351
2000, Texas,El Paso County,48141,2000,679622,502579,147968,531654
2020, Texas,Val Verde County,48465,2020,47586,21218,9379,38207
2020, Texas,Van Zandt County,48467,2020,59541,49904,52470,7071
2000, Texas,Van Zandt County,48467,2000,48140,44268,44939,3201
2010, Texas,Van Zandt County,48467,2010,52579,47784,47732,4847
2020, Texas,Donley County,48129,2020,3258,2648,2902,356
2020, Texas,Delta County,48119,2020,5230,4317,4836,394
2000, Texas,Delta County,48119,2000,5327,4684,5162,165
2010, Texas,Delta County,48119,2010,5231,4461,4943,288
2020, Texas,Denton County,48121,2020,906422,526363,723644,182778
2010, Texas,Denton County,48121,2010,662614,497260,541778,120836
2000, Texas,Denton County,48121,2000,432976,353855,380357,52619
2000, Texas,Dickens County,48125,2000,2762,2144,2102,660
2010, Texas,Val Verde County,48465,2010,48879,41534,9680,39199
2010, Texas,Dickens County,48125,2010,2444,2052,1736,708
2010, Texas,Victoria County,48469,2010,86793,69013,48680,38113
2020, Texas,Victoria County,48469,2020,91319,53085,48388,42931
2020, Texas,Dimmit County,48127,2020,8615,3852,1128,7487
2010, Texas,Dimmit County,48127,2010,9996,8860,1380,8616
2000, Texas,Dimmit County,48127,2000,10248,7886,1540,8708
2010, Texas,Donley County,48129,2010,3677,3307,3368,309
2000, Texas,Donley County,48129,2000,3828,3499,3585,243
2020, Texas,Dickens County,48125,2020,1770,1363,1258,512
2000, Texas,Val Verde County,48465,2000,44856,34251,11007,33849
2000, Texas,Uvalde County,48463,2000,25926,19621,8837,17089
2020, Texas,Uvalde County,48463,2020,24564,12584,7247,17317
2010, Texas,Fayette County,48149,2010,24554,20491,19969,4585
2000, Texas,Fayette County,48149,2000,21804,18442,19018,2786
2020, Texas,Fayette County,48149,2020,24435,18286,19219,5216
2020, Texas,Fisher County,48151,2020,3672,2921,2699,973
2010, Texas,Fisher County,48151,2010,3974,3444,2975,999
2000, Texas,Fisher County,48151,2000,4344,3638,3416,928
2010, Texas,Floyd County,48153,2010,6446,4916,3036,3410
2020, Texas,Fannin County,48147,2020,35662,28249,31444,4218
2020, Texas,Floyd County,48153,2020,5402,3101,2335,3067
2000, Texas,Tyler County,48457,2000,20871,17487,20129,742
2020, Texas,Tyler County,48457,2020,19798,15621,18278,1520
2000, Texas,Floyd County,48153,2000,7771,5763,4202,3569
2010, Texas,Foard County,48155,2010,1336,1211,1149,187
2000, Texas,Foard County,48155,2000,1622,1365,1357,265
2020, Texas,Foard County,48155,2020,1095,924,898,197
2010, Texas,Fort Bend County,48157,2010,585375,296310,446408,138967
2010, Texas,Tyler County,48457,2010,21766,17930,20279,1487
2000, Texas,Deaf Smith County,48117,2000,18561,13415,7907,10654
2000, Texas,Fannin County,48147,2000,31242,27043,29489,1753
2010, Texas,Falls County,48145,2010,17866,10832,14150,3716
2010, Texas,Uvalde County,48463,2010,26405,20631,8106,18299
2010, Texas,El Paso County,48141,2010,800647,656993,142513,658134
2000, Texas,Ellis County,48139,2000,111360,89789,90852,20508
2020, Texas,Ellis County,48139,2020,192455,118993,140423,52032
2010, Texas,Upton County,48461,2010,3355,2516,1711,1644
2000, Texas,Upton County,48461,2000,3404,2648,1955,1449
2020, Texas,Upton County,48461,2020,3308,1849,1511,1797
2010, Texas,Fannin County,48147,2010,33915,29172,30689,3226
2010, Texas,Ellis County,48139,2010,149610,117662,114449,35161
2020, Texas,Upshur County,48459,2020,40892,32238,36906,3986
2010, Texas,Upshur County,48459,2010,39309,33466,36696,2613
2000, Texas,Erath County,48143,2000,33001,29610,28042,4959
2010, Texas,Erath County,48143,2010,37890,32441,30611,7279
2020, Texas,Erath County,48143,2020,42545,32674,33291,9254
2020, Texas,Falls County,48145,2020,16968,9870,13003,3965
2000, Texas,Falls County,48145,2000,18576,11424,15635,2941
2000, Texas,Upshur County,48459,2000,35291,30246,33897,1394
2010, Texas,Childress County,48075,2010,7041,5774,5156,1885
2020, Texas,Deaf Smith County,48117,2020,18583,9054,4658,13925
2000, Texas,DeWitt County,48123,2000,20013,15293,14561,5452
2000, Texas,Collingsworth County,48087,2000,3206,2559,2551,655
2010, Texas,Collingsworth County,48087,2010,3057,2338,2141,916
2020, Texas,Colorado County,48089,2020,20557,13169,14567,5990
2000, Texas,Colorado County,48089,2000,20390,14841,16366,4024
2010, Texas,Colorado County,48089,2010,20874,15676,15422,5452
2000, Texas,Comal County,48091,2000,78021,69501,60412,17609
2020, Texas,Comal County,48091,2020,161501,118292,117911,43590
2010, Texas,Comal County,48091,2010,108472,97044,81483,26989
2000, Texas,Comanche County,48093,2000,14026,12245,11098,2928
2010, Texas,Comanche County,48093,2010,13974,12417,10369,3605
2020, Texas,Comanche County,48093,2020,13594,10295,9727,3867
2020, Texas,Concho County,48095,2020,3303,2518,2270,1033
2010, Texas,Concho County,48095,2010,4087,3553,1914,2173
2000, Texas,Concho County,48095,2000,3966,3498,2327,1639
2000, Texas,Cooke County,48097,2000,36363,32305,32736,3627
2020, Texas,Collingsworth County,48087,2020,2652,1928,1820,832
2000, Texas,Collin County,48085,2000,491675,400181,441165,50510
2020, Texas,Collin County,48085,2020,1064465,578412,895307,169158
2010, Texas,Collin County,48085,2010,782341,560036,666987,115354
2000, Texas,Childress County,48075,2000,7688,5205,6114,1574
2010, Texas,Washington County,48477,2010,33718,25008,29077,4641
2020, Texas,Washington County,48477,2020,35805,23299,29380,6425
2000, Texas,Washington County,48477,2000,30373,22682,27726,2647
2000, Texas,Clay County,48077,2000,11006,10494,10602,404
2020, Texas,Clay County,48077,2020,10218,9178,9577,641
2010, Texas,Clay County,48077,2010,10752,10224,10285,467
2020, Texas,Cooke County,48097,2020,41668,31641,33149,8519
2000, Texas,Cochran County,48079,2000,3730,2405,2084,1646
2020, Texas,Cochran County,48079,2020,2547,1448,1020,1527
2000, Texas,Coke County,48081,2000,3864,3433,3211,653
2020, Texas,Coke County,48081,2020,3285,2721,2624,661
2010, Texas,Coke County,48081,2010,3320,3036,2718,602
2010, Texas,Coleman County,48083,2010,8895,7841,7476,1419
2020, Texas,Coleman County,48083,2020,7684,6582,6492,1192
2000, Texas,Coleman County,48083,2000,9235,8176,7946,1289
2010, Texas,Cochran County,48079,2010,3127,2288,1473,1654
2010, Texas,Cooke County,48097,2010,38437,32943,32440,5997
2020, Texas,Coryell County,48099,2020,83093,50529,66611,16482
2000, Texas,Coryell County,48099,2000,74978,48946,65554,9424
2010, Texas,Dallam County,48111,2010,6703,5371,3986,2717
2000, Texas,Dallam County,48111,2000,6222,5142,4456,1766
2000, Texas,Dallas County,48113,2000,2218899,1294769,1556170,662729
2010, Texas,Waller County,48473,2010,43205,25254,30669,12536
2020, Texas,Waller County,48473,2020,56794,26479,38308,18486
2000, Texas,Waller County,48473,2000,32663,18889,26319,6344
2010, Texas,Dallas County,48113,2010,2368139,1267861,1462199,905940
2020, Texas,Dallam County,48111,2020,7115,3879,3408,3707
2020, Texas,Dallas County,48113,2020,2613539,924283,1555704,1057835
2000, Texas,Walker County,48471,2000,61758,42686,53046,8712
2020, Texas,Walker County,48471,2020,76400,42800,59822,16578
2010, Texas,Dawson County,48115,2010,13833,10606,6446,7387
2020, Texas,Dawson County,48115,2020,12456,7609,5689,6767
2000, Texas,Dawson County,48115,2000,14985,10859,7763,7222
2020, Texas,DeWitt County,48123,2020,19824,13313,12934,6890
2010, Texas,DeWitt County,48123,2010,20097,15206,13595,6502
2010, Texas,Walker County,48471,2010,67861,45511,56472,11389
2010, Texas,Deaf Smith County,48117,2010,19372,15075,6333,13039
2000, Texas,Culberson County,48109,2000,2975,2051,826,2149
2020, Texas,Culberson County,48109,2020,2188,1014,543,1645
2010, Texas,Coryell County,48099,2010,75388,53033,63415,11973
2010, Texas,Cottle County,48101,2010,1505,1212,1189,316
2020, Texas,Cottle County,48101,2020,1380,1027,1053,327
2000, Texas,Cottle County,48101,2000,1904,1551,1544,360
2000, Texas,Crane County,48103,2000,3996,2945,2243,1753
2010, Texas,Crane County,48103,2010,4375,3243,1966,2409
2020, Texas,Crane County,48103,2020,4675,2488,1517,3158
2010, Texas,Culberson County,48109,2010,2398,1892,571,1827
2000, Texas,Crockett County,48105,2000,4099,3129,1857,2242
2020, Texas,Crockett County,48105,2020,3098,1882,1178,1920
2000, Texas,Crosby County,48107,2000,7072,4510,3612,3460
2010, Texas,Ward County,48475,2010,10658,8227,5584,5074
2000, Texas,Ward County,48475,2000,10909,8704,6329,4580
2020, Texas,Ward County,48475,2020,11644,6567,5319,6325
2010, Texas,Crosby County,48107,2010,6059,4784,2888,3171
2020, Texas,Crosby County,48107,2020,5133,3257,2304,2829
2010, Texas,Crockett County,48105,2010,3719,3092,1367,2352
2000, Texas,Stephens County,48429,2000,9674,8406,8256,1418
2020, Texas,Reagan County,48383,2020,3385,1736,1102,2283
2020, Texas,Jack County,48237,2020,8472,6663,6951,1521
2010, Texas,Menard County,48327,2010,2242,1847,1452,790
2000, Texas,La Salle County,48283,2000,5866,4779,1342,4524
2020, Texas,La Salle County,48283,2020,6664,3189,1756,4908
2010, Texas,La Salle County,48283,2010,6886,6176,966,5920
2020, Texas,Menard County,48327,2020,1962,1511,1300,662
2010, Texas,Somervell County,48425,2010,8490,7220,6864,1626
2020, Texas,Somervell County,48425,2020,9205,7373,7518,1687
2000, Texas,Somervell County,48425,2000,6809,6277,5894,915
2000, Texas,Menard County,48327,2000,2360,2066,1612,748
2010, Texas,Roberts County,48393,2010,929,871,855,74
2020, Texas,Roberts County,48393,2020,827,737,777,50
2000, Texas,Roberts County,48393,2000,887,856,859,28
2000, Texas,Rains County,48379,2000,9139,8400,8634,505
2020, Texas,Robertson County,48395,2020,16757,10502,13229,3528
2000, Texas,Robertson County,48395,2000,16000,10592,13641,2359
2000, Texas,Medina County,48325,2000,39304,31200,21431,17873
2020, Texas,Medina County,48325,2020,50748,31848,25293,25455
2010, Texas,Lamar County,48277,2010,49793,39489,46570,3223
2000, Texas,Schleicher County,48413,2000,2935,2248,1657,1278
2000, Texas,McCulloch County,48307,2000,8205,6945,5986,2219
2010, Texas,McCulloch County,48307,2010,8283,6947,5807,2476
2000, Texas,McLennan County,48309,2000,213517,154087,175284,38233
2020, Texas,McLennan County,48309,2020,260579,156475,191992,68587
2010, Texas,McLennan County,48309,2010,234906,164037,179435,55471
2010, Texas,McMullen County,48311,2010,707,643,446,261
2020, Texas,Lamb County,48279,2020,13045,7369,5596,7449
2020, Texas,Midland County,48329,2020,169983,98404,96652,73331
2020, Texas,McMullen County,48311,2020,600,411,376,224
2010, Texas,Lamb County,48279,2010,13977,10403,6746,7231
2020, Texas,Lamar County,48277,2020,50088,36479,45676,4412
2000, Texas,McMullen County,48311,2000,851,752,569,282
2010, Texas,Medina County,48325,2010,46006,39369,23135,22871
2010, Texas,Schleicher County,48413,2010,3461,2780,1925,1536
2000, Texas,Lamar County,48277,2000,48499,39990,46885,1614
2020, Texas,Schleicher County,48413,2020,2451,1368,1176,1275
2000, Texas,Lamb County,48279,2000,14709,11193,8316,6393
2020, Texas,McCulloch County,48307,2020,7630,5821,5261,2369
2020, Texas,Knox County,48275,2020,3353,2393,2223,1130
2000, Texas,Midland County,48329,2000,116009,89702,82333,33676
2020, Texas,Kinney County,48271,2020,3129,2012,1659,1470
2000, Texas,Mitchell County,48335,2000,9698,7227,6689,3009
2010, Texas,Pecos County,48371,2010,15507,12307,5077,10430
2020, Texas,Pecos County,48371,2020,15193,6921,4348,10845
2010, Texas,San Saba County,48411,2010,6131,5166,4416,1715
2000, Texas,San Saba County,48411,2000,6186,5227,4853,1333
2020, Texas,San Saba County,48411,2020,5730,4274,3981,1749
2000, Texas,San Patricio County,48409,2000,67138,51533,33957,33181
2010, Texas,San Patricio County,48409,2010,64804,55660,29556,35248
2010, Texas,Refugio County,48391,2010,7383,5943,3896,3487
2020, Texas,Refugio County,48391,2020,6741,4172,3435,3306
2020, Texas,Reeves County,48389,2020,14748,8073,2238,12510
2020, Texas,San Patricio County,48409,2020,68755,42197,30535,38220
2000, Texas,Pecos County,48371,2000,16809,12749,6547,10262
2000, Texas,Montague County,48337,2000,19117,18343,18082,1035
2020, Texas,Limestone County,48293,2020,22146,14018,17133,5013
2010, Texas,Mitchell County,48335,2010,9403,6433,5922,3481
2020, Texas,Mitchell County,48335,2020,8990,5399,5536,3454
2020, Texas,Stephens County,48429,2020,9101,7013,6897,2204
2020, Texas,Milam County,48331,2020,24754,17261,18490,6264
2000, Texas,Knox County,48275,2000,4253,3162,3186,1067
2010, Texas,Knox County,48275,2010,3719,2842,2618,1101
2020, Texas,Rains County,48379,2020,12164,10394,11055,1109
2010, Texas,Rains County,48379,2010,10914,9953,10075,839
2000, Texas,Refugio County,48391,2000,7828,6280,4338,3490
2000, Texas,Milam County,48331,2000,24238,19121,19722,4516
2010, Texas,Midland County,48329,2010,136872,105302,85272,51600
2010, Texas,Milam County,48331,2010,24757,19347,18977,5780
2000, Texas,Kleberg County,48273,2000,31549,22675,10914,20635
2010, Texas,Kleberg County,48273,2010,32061,25618,9566,22495
2020, Texas,Kleberg County,48273,2020,31040,17266,9120,21920
2010, Texas,Mills County,48333,2010,4936,4440,4118,818
2000, Texas,Mills County,48333,2000,5151,4597,4480,671
2010, Texas,Robertson County,48395,2010,16622,11247,13632,2990
2010, Texas,Kinney County,48271,2010,3598,3187,1594,2004
2020, Texas,Mills County,48333,2020,4456,3654,3728,728
2020, Texas,Smith County,48423,2020,233479,144539,186198,47281
2010, Texas,Smith County,48423,2010,209714,147086,173626,36088
2000, Texas,Smith County,48423,2000,174706,126853,155185,19521
2010, Texas,Llano County,48299,2010,19301,18319,17759,1542
2000, Texas,Potter County,48375,2000,113546,77890,81625,31921
2000, Texas,Leon County,48289,2000,15335,12809,14122,1213
2020, Texas,Leon County,48289,2020,15719,12391,13273,2446
2010, Texas,Potter County,48375,2010,121073,84523,78381,42692
2020, Texas,Llano County,48299,2020,21243,18388,18735,2508
2000, Texas,Llano County,48299,2000,17044,16408,16169,875
2020, Texas,Potter County,48375,2020,118525,61693,73332,45193
2000, Texas,Loving County,48301,2000,67,60,60,7
2020, Texas,Loving County,48301,2020,64,56,63,1
2010, Texas,Loving County,48301,2010,82,65,64,18
2010, Texas,Lubbock County,48303,2010,278831,215519,189907,88924
2020, Texas,Lubbock County,48303,2020,310639,191717,201469,109170
2010, Texas,Leon County,48289,2010,16801,14258,14541,2260
2000, Texas,Lubbock County,48303,2000,242628,180269,176019,66609
2020, Texas,Live Oak County,48297,2020,11335,8419,6545,4790
2010, Texas,Shelby County,48419,2010,25448,17467,21284,4164
2000, Texas,Shelby County,48419,2000,25224,18324,22735,2489
2020, Texas,Shelby County,48419,2020,24022,15111,19337,4685
2000, Texas,Sherman County,48421,2000,3186,2628,2312,874
2010, Texas,Sherman County,48421,2010,3034,2680,1807,1227
2020, Texas,Sherman County,48421,2020,2782,1612,1467,1315
2000, Texas,Limestone County,48293,2000,22051,15602,19192,2859
2010, Texas,Limestone County,48293,2010,23384,16139,18919,4465
2000, Texas,Liberty County,48291,2000,70154,55355,62494,7660
2020, Texas,Liberty County,48291,2020,91628,55857,60831,30797
2020, Texas,Lynn County,48305,2020,5596,3724,3244,2352
2010, Texas,Presidio County,48377,2010,7818,6715,1297,6521
2010, Texas,Liberty County,48291,2010,75643,58363,62041,13602
2020, Texas,Lipscomb County,48295,2020,3059,1969,1936,1123
2000, Texas,Lipscomb County,48295,2000,3057,2533,2424,633
2010, Texas,Lipscomb County,48295,2010,3302,2845,2295,1007
2000, Texas,Live Oak County,48297,2000,12309,10743,7626,4683
2010, Texas,Live Oak County,48297,2010,11531,10107,7471,4060
2020, Texas,Presidio County,48377,2020,6131,2331,1140,4991
2000, Texas,Presidio County,48377,2000,7304,6205,1142,6162
2010, Texas,Lynn County,48305,2010,5915,4748,3172,2743
2000, Texas,Lee County,48287,2000,15657,11992,12809,2848
2020, Texas,Lee County,48287,2020,17478,11744,12999,4479
2000, Texas,Scurry County,48415,2000,16361,13296,11817,4544
2010, Texas,Martin County,48317,2010,4799,4067,2713,2086
2020, Texas,Martin County,48317,2020,5237,3580,2982,2255
2000, Texas,Martin County,48317,2000,4746,3750,2821,1925
2000, Texas,Mason County,48319,2000,3738,3424,2955,783
2020, Texas,Mason County,48319,2020,3953,3188,3070,883
2010, Texas,Mason County,48319,2010,4012,3731,3148,864
2020, Texas,Scurry County,48415,2020,16932,10867,9793,7139
2000, Texas,Matagorda County,48321,2000,37957,25745,26059,11898
2010, Texas,Matagorda County,48321,2010,36702,26137,22628,14074
2010, Texas,Maverick County,48323,2010,54258,49617,2344,51914
2000, Texas,Maverick County,48323,2000,47297,33529,2359,44938
2000, Texas,Lampasas County,48281,2000,17762,15409,15085,2677
2020, Texas,Lampasas County,48281,2020,21627,16337,17448,4179
2010, Texas,Lampasas County,48281,2010,19677,16792,16234,3443
2020, Texas,Maverick County,48323,2020,57887,16845,2951,54936
2020, Texas,Matagorda County,48321,2020,36255,19753,20800,15455
2010, Texas,Montague County,48337,2010,19719,18384,17789,1930
2010, Texas,Scurry County,48415,2010,16921,13325,10772,6149
2010, Texas,Marion County,48315,2010,10546,7752,10218,328
2000, Texas,Lynn County,48305,2000,6550,4947,3627,2923
2000, Texas,Shackelford County,48417,2000,3302,3111,3051,251
2020, Texas,Shackelford County,48417,2020,3105,2731,2742,363
2010, Texas,Shackelford County,48417,2010,3378,3145,3038,340
2000, Texas,Madison County,48313,2000,12940,8642,10898,2042
2010, Texas,Madison County,48313,2010,13664,9149,10976,2688
2020, Texas,Madison County,48313,2020,13455,7695,10040,3415
2000, Texas,Marion County,48315,2000,10941,7958,10678,263
2010, Texas,Runnels County,48399,2010,10501,8735,7140,3361
2010, Texas,Lavaca County,48285,2010,19263,16563,16186,3077
2000, Texas,Lavaca County,48285,2000,19210,16686,17027,2183
2000, Texas,Polk County,48373,2000,41133,32760,37272,3861
2020, Texas,Polk County,48373,2020,50123,36343,42778,7345
2010, Texas,Polk County,48373,2010,45413,35082,39454,5959
2020, Texas,Marion County,48315,2020,9725,6968,9336,389
2020, Texas,Lavaca County,48285,2020,20337,15821,16401,3936
2010, Texas,Lee County,48287,2010,16612,13101,12888,3724
2000, Texas,Reeves County,48389,2000,13137,10421,3497,9640
2000, Texas,Kinney County,48271,2000,3379,2562,1672,1707
2020, Texas,Montague County,48337,2020,19965,17066,17604,2361
2010, Texas,Nolan County,48353,2010,15216,12728,10113,5103
2020, Texas,Jim Wells County,48249,2020,38891,22187,8056,30835
2000, Texas,Jim Wells County,48249,2000,39326,30634,9554,29772
2000, Texas,Palo Pinto County,48363,2000,27026,23835,23359,3667
2000, Texas,Nolan County,48353,2000,15802,12397,11371,4431
2020, Texas,Nolan County,48353,2020,14738,10235,9384,5354
2020, Texas,Palo Pinto County,48363,2020,28409,22603,22795,5614
2010, Texas,Jim Wells County,48249,2010,40838,35620,8584,32254
2010, Texas,Jim Hogg County,48247,2010,5300,4658,393,4907
2020, Texas,Jim Hogg County,48247,2020,4838,2333,557,4281
2000, Texas,Red River County,48387,2000,14314,11170,13645,669
2020, Texas,Red River County,48387,2020,11587,8700,10821,766
2020, Texas,Nueces County,48355,2020,353178,191405,136126,217052
2000, Texas,Nueces County,48355,2000,313645,225912,138694,174951
2000, Texas,Jim Hogg County,48247,2000,5281,4248,529,4752
2010, Texas,Panola County,48365,2010,23796,18267,21826,1970
2000, Texas,Johnson County,48251,2000,126811,114142,111436,15375
2020, Texas,Panola County,48365,2020,22491,16637,20301,2190
2010, Texas,Navarro County,48349,2010,47735,33142,36390,11345
2020, Texas,Newton County,48351,2020,12217,9375,11873,344
2020, Texas,Jones County,48253,2020,19663,12902,14159,5504
2000, Texas,Jones County,48253,2000,20785,16378,16439,4346
2010, Texas,Jones County,48253,2010,20202,14375,15193,5009
2010, Texas,Newton County,48351,2010,14445,11105,14042,403
2000, Texas,Newton County,48351,2000,15072,11431,14501,571
2000, Texas,Parmer County,48369,2000,10016,6612,5089,4927
2020, Texas,Parmer County,48369,2020,9869,5572,3365,6504
2020, Texas,Parker County,48367,2020,148222,122995,128403,19819
2010, Texas,Parker County,48367,2010,116927,106862,104517,12410
2010, Texas,Reeves County,48389,2010,13783,10645,3550,10233
2010, Texas,Johnson County,48251,2010,150934,131622,123615,27319
2000, Texas,Parker County,48367,2000,88495,81955,82284,6211
2000, Texas,Panola County,48365,2000,22756,17927,21958,798
2010, Texas,Nueces County,48355,2010,340223,277402,133930,206293
2010, Texas,Sabine County,48403,2010,10834,9658,10490,344
2010, Texas,Palo Pinto County,48363,2010,28111,24497,23126,4985
2020, Texas,Jefferson County,48245,2020,256526,108905,197611,58915
2000, Texas,Rusk County,48401,2000,47372,35477,43374,3998
2020, Texas,Rusk County,48401,2020,52214,33865,42635,9579
2010, Texas,Rusk County,48401,2010,53330,38512,45721,7609
2000, Texas,Orange County,48361,2000,84966,74749,81893,3073
2010, Texas,Real County,48385,2010,3309,2996,2495,814
2020, Texas,Real County,48385,2020,2758,2213,2066,692
2010, Texas,Orange County,48361,2010,81837,70478,77071,4766
2020, Texas,Orange County,48361,2020,84808,66942,77543,7265
2000, Texas,Real County,48385,2000,3047,2785,2359,688
2010, Texas,Reagan County,48383,2010,3367,2596,1316,2051
2000, Texas,Runnels County,48399,2000,11495,9361,8123,3372
2020, Texas,Runnels County,48399,2020,9900,7480,6546,3354
2010, Texas,Jackson County,48239,2010,14075,11446,9996,4079
2000, Texas,Jackson County,48239,2000,14391,11008,10840,3551
2020, Texas,Jackson County,48239,2020,14988,9782,10159,4829
2000, Texas,Oldham County,48359,2000,2185,1981,1944,241
2000, Texas,Navarro County,48349,2000,45124,31966,38011,7113
2010, Texas,Oldham County,48359,2010,2052,1850,1809,243
2010, Texas,Ochiltree County,48357,2010,10223,8747,5241,4982
2000, Texas,Jefferson County,48245,2000,252051,144274,225515,26536
2010, Texas,Jefferson County,48245,2010,252273,131574,209374,42899
2020, Texas,Jeff Davis County,48243,2020,1996,1467,1383,613
2000, Texas,Jeff Davis County,48243,2000,2207,1998,1424,783
2010, Texas,Jeff Davis County,48243,2010,2342,2113,1552,790
2000, Texas,Jasper County,48241,2000,35604,27855,34220,1384
2020, Texas,Jasper County,48241,2020,32980,24327,30782,2198
2010, Texas,Jasper County,48241,2010,35710,27738,33693,2017
2020, Texas,Starr County,48427,2020,65920,21839,1527,64393
2010, Texas,Starr County,48427,2010,60968,58585,2631,58337
2000, Texas,Starr County,48427,2000,53597,47120,1319,52278
2020, Texas,Sabine County,48403,2020,9894,8426,9501,393
2000, Texas,Sabine County,48403,2000,10469,9197,10280,189
2000, Texas,Ochiltree County,48357,2000,9006,7763,6143,2863
2020, Texas,Ochiltree County,48357,2020,10015,5618,4545,5470
2020, Texas,Oldham County,48359,2020,1758,1424,1445,313
2020, Texas,Navarro County,48349,2020,52624,30019,36575,16049
2020, Texas,Johnson County,48251,2020,179927,129863,137314,42613
2010, Texas,Rockwall County,48397,2010,78337,65514,65867,12470
2010, Texas,Kaufman County,48257,2010,103350,81776,85802,17548
2000, Texas,Kaufman County,48257,2000,71313,57837,63388,7925
2000, Texas,Kendall County,48259,2000,23743,22047,19495,4248
2020, Texas,Kerr County,48265,2020,52598,39702,39000,13598
2010, Texas,Kendall County,48259,2010,33410,30299,26581,6829
2010, Texas,Kenedy County,48261,2010,416,364,97,319
2020, Texas,Moore County,48341,2020,21358,9445,8711,12647
2020, Texas,Kenedy County,48261,2020,350,137,89,261
2000, Texas,Kenedy County,48261,2000,414,267,87,327
2010, Texas,Moore County,48341,2010,21904,15886,10362,11542
2000, Texas,Randall County,48381,2000,104312,94340,93594,10718
2020, Texas,Kaufman County,48257,2020,145310,87435,109145,36165
2000, Texas,San Jacinto County,48407,2000,22246,18606,21162,1084
2000, Texas,Kent County,48263,2000,859,820,781,78
2020, Texas,Kent County,48263,2020,753,676,672,81
2010, Texas,Kent County,48263,2010,808,753,688,120
2010, Texas,Kerr County,48265,2010,49625,43505,37730,11895
2010, Texas,San Jacinto County,48407,2010,26384,21693,23504,2880
2020, Texas,San Jacinto County,48407,2020,27402,20276,22580,4822
2010, Texas,Kimble County,48267,2010,4607,4216,3530,1077
2000, Texas,Kimble County,48267,2000,4468,4034,3542,926
2010, Texas,Randall County,48381,2010,120725,107305,100950,19775
2020, Texas,Randall County,48381,2020,140753,105870,109170,31583
2000, Texas,Moore County,48341,2000,20121,12864,10563,9558
2010, Texas,Parmer County,48369,2010,10269,7969,4105,6164
2010, Texas,Karnes County,48255,2010,14824,10408,7448,7376
2020, Texas,Kendall County,48259,2020,44279,34449,34250,10029
2020, Texas,Karnes County,48255,2020,14710,8215,6976,7734
2020, Texas,Montgomery County,48339,2020,620443,407926,456354,164089
2000, Texas,Rockwall County,48397,2000,43080,38414,38309,4771
2020, Texas,Rockwall County,48397,2020,107819,74913,87259,20560
2020, Texas,Nacogdoches County,48347,2020,64653,40228,51056,13597
2010, Texas,Red River County,48387,2010,12860,9838,12011,849
2010, Texas,Nacogdoches County,48347,2010,64524,44249,53168,11356
2020, Texas,Kimble County,48267,2020,4286,3533,3300,986
2000, Texas,San Augustine County,48405,2000,8946,6196,8626,320
2020, Texas,King County,48269,2020,265,242,240,25
2000, Texas,King County,48269,2000,356,335,322,34
2000, Texas,Montgomery County,48339,2000,293768,259258,256618,37150
2010, Texas,Montgomery County,48339,2010,455746,380593,361048,94698
2010, Texas,San Augustine County,48405,2010,8865,6375,8333,532
2020, Texas,San Augustine County,48405,2020,7918,5352,7279,639
2010, Texas,King County,48269,2010,286,268,247,39
2000, Texas,Nacogdoches County,48347,2000,59203,44405,52543,6660
2000, Texas,Kerr County,48265,2000,43653,38802,35300,8353
2010, Texas,Motley County,48345,2010,1210,1115,1047,163
2000, Texas,Motley County,48345,2000,1426,1246,1253,173
2000, Texas,Karnes County,48255,2000,15446,10588,8122,7324
2000, Texas,Morris County,48343,2000,13048,9357,12571,477
2010, Texas,Morris County,48343,2010,12934,9014,11931,1003
2020, Texas,Motley County,48345,2020,1063,931,910,153
2020, Texas,Morris County,48343,2020,11973,8043,10791,1182
2010, Utah,Carbon County,49007,2010,21403,19757,18744,2659
2000, Utah,San Juan County,49037,2000,14413,5876,13873,540
2020, Utah,San Juan County,49037,2020,14518,6275,13771,747
2020, Utah,Garfield County,49017,2020,5083,4541,4699,384
2010, Utah,Beaver County,49001,2010,6629,5900,5913,716
2000, Utah,Tooele County,49045,2000,40735,36330,36521,4214
2000, Utah,Sanpete County,49039,2000,22763,21040,21253,1510
2010, Utah,Sanpete County,49039,2010,27822,25158,25203,2619
2000, Utah,Beaver County,49001,2000,6005,5599,5672,333
2010, Utah,Daggett County,49009,2010,1059,1016,1026,33
2000, Utah,Daggett County,49009,2000,921,871,874,47
2000, Utah,Wayne County,49055,2000,2509,2441,2459,50
2020, Utah,Wayne County,49055,2020,2486,2283,2390,96
2010, Utah,Wayne County,49055,2010,2778,2634,2662,116
2020, Utah,Daggett County,49009,2020,935,884,906,29
2020, Utah,Carbon County,49007,2020,20412,17643,17735,2677
2010, Utah,Garfield County,49017,2010,5172,4869,4938,234
2020, Utah,Beaver County,49001,2020,7072,5904,6006,1066
2010, Utah,Weber County,49057,2010,231236,197101,192525,38711
2000, Utah,Carbon County,49007,2000,20422,18601,18325,2097
2010, Utah,Tooele County,49045,2010,58218,52804,51557,6661
2020, Utah,Weber County,49057,2020,262223,205396,213481,48742
2000, Utah,Garfield County,49017,2000,4735,4496,4599,136
2010, Utah,San Juan County,49037,2010,14746,6759,14097,649
2000, Utah,Weber County,49057,2000,196533,172339,171675,24858
2000, Utah,Millard County,49027,2000,12405,11653,11514,891
2000, Utah,Uintah County,49047,2000,25224,22130,24330,894
2010, Utah,Washington County,49053,2010,138115,123914,124629,13486
2000, Utah,Washington County,49053,2000,90354,84543,85627,4727
2010, Utah,Wasatch County,49051,2010,23530,21275,20346,3184
2020, Utah,Wasatch County,49051,2020,34788,29131,29742,5046
2000, Utah,Wasatch County,49051,2000,15215,14549,14440,775
2000, Utah,Piute County,49031,2000,1435,1372,1371,64
2010, Utah,Piute County,49031,2010,1556,1474,1447,109
2020, Utah,Piute County,49031,2020,1438,1291,1314,124
2010, Utah,Duchesne County,49013,2010,18607,16589,17490,1117
2000, Utah,Duchesne County,49013,2000,14371,12956,13863,508
2020, Utah,Duchesne County,49013,2020,19596,17076,18311,1285
2000, Utah,Box Elder County,49003,2000,42745,39699,39954,2791
2010, Utah,Salt Lake County,49035,2010,1029655,836074,853640,176015
2010, Utah,Box Elder County,49003,2010,49975,45861,45823,4152
2020, Utah,Box Elder County,49003,2020,57666,50784,52129,5537
2020, Utah,Salt Lake County,49035,2020,1185238,847970,953150,232088
2000, Utah,Salt Lake County,49035,2000,898387,775666,791600,106787
2020, Utah,Utah County,49049,2020,659399,537757,570868,88531
2010, Utah,Utah County,49049,2010,516564,461775,460771,55793
2000, Utah,Utah County,49049,2000,368536,340388,342745,25791
2010, Utah,Emery County,49015,2010,10976,10309,10322,654
2010, Utah,Uintah County,49047,2010,32588,28232,30258,2330
2020, Utah,Uintah County,49047,2020,35620,29607,32786,2834
2010, Utah,Cache County,49005,2010,112656,100397,101440,11216
2000, Utah,Davis County,49011,2000,238994,220486,226039,12955
2020, Utah,Davis County,49011,2020,362679,302352,323384,39295
2010, Utah,Davis County,49011,2010,306479,275956,280726,25753
2020, Utah,Morgan County,49029,2020,12295,11691,11957,338
2020, Utah,Millard County,49027,2020,12975,10855,11201,1774
2020, Utah,Sanpete County,49039,2020,28437,24277,25394,3043
2010, Utah,Millard County,49027,2010,12503,10950,10900,1603
2020, Utah,Sevier County,49041,2020,21522,19667,20469,1053
2000, Utah,Cache County,49005,2000,91391,84286,85605,5786
2020, Utah,Cache County,49005,2020,133154,112842,118078,15076
2010, Utah,Morgan County,49029,2010,9469,9234,9243,226
2000, Utah,Morgan County,49029,2000,7129,6994,7026,103
2020, Utah,Emery County,49015,2020,9825,9003,9120,705
2020, Utah,Washington County,49053,2020,180279,151777,159797,20482
2000, Utah,Emery County,49015,2000,10860,10386,10292,568
2000, Utah,Sevier County,49041,2000,18842,18014,18361,481
2020, Utah,Tooele County,49045,2020,72698,61011,63176,9522
2010, Utah,Sevier County,49041,2010,20802,19734,19870,932
2010, Utah,Kane County,49025,2010,7125,6816,6862,263
2020, Utah,Grand County,49019,2020,9669,7817,8443,1226
2010, Utah,Grand County,49019,2010,9225,8207,8344,881
2020, Utah,Kane County,49025,2020,7667,7084,7345,322
2020, Utah,Rich County,49033,2020,2510,2359,2413,97
2000, Utah,Grand County,49019,2000,8485,7861,8014,471
2010, Utah,Iron County,49021,2010,46163,41848,42600,3563
2000, Utah,Iron County,49021,2000,33779,31416,32396,1383
2020, Utah,Iron County,49021,2020,57289,49237,51807,5482
2000, Utah,Rich County,49033,2000,1961,1925,1925,36
2010, Utah,Rich County,49033,2010,2264,2196,2168,96
2000, Utah,Kane County,49025,2000,6046,5804,5906,140
2020, Utah,Summit County,49043,2020,42357,35927,37620,4737
2000, Utah,Summit County,49043,2000,29736,27299,27330,2406
2020, Utah,Juab County,49023,2020,11786,10972,11212,574
2010, Utah,Juab County,49023,2010,10246,9831,9867,379
2000, Utah,Juab County,49023,2000,8238,7955,8021,217
2010, Utah,Summit County,49043,2010,36324,32890,32134,4190
2020, Vermont,Bennington County,50003,2020,37347,34183,36408,939
2010, Vermont,Rutland County,50021,2010,61642,59829,60961,681
2020, Vermont,Rutland County,50021,2020,60572,55453,59347,1225
2010, Vermont,Franklin County,50011,2010,47746,45648,47175,571
2020, Vermont,Franklin County,50011,2020,49946,45509,49031,915
2010, Vermont,Addison County,50001,2010,36821,35078,36136,685
2000, Vermont,Addison County,50001,2000,35974,34844,35577,397
2010, Vermont,Lamoille County,50015,2010,24475,23656,24153,322
2000, Vermont,Bennington County,50003,2000,36994,36161,36650,344
2010, Vermont,Bennington County,50003,2010,37125,35858,36600,525
2020, Vermont,Chittenden County,50007,2020,168323,144237,163572,4751
2020, Vermont,Washington County,50023,2020,59807,54149,58238,1569
2000, Vermont,Essex County,50009,2000,6459,6237,6427,32
2020, Vermont,Essex County,50009,2020,5920,5566,5853,67
2010, Vermont,Essex County,50009,2010,6306,6138,6247,59
2000, Vermont,Windsor County,50027,2000,57418,56107,56950,468
2020, Vermont,Windsor County,50027,2020,57753,52881,56523,1230
2010, Vermont,Windsor County,50027,2010,56670,54563,55974,696
2020, Vermont,Addison County,50001,2020,37363,33793,36210,1153
2020, Vermont,Windham County,50025,2020,45905,41380,44572,1333
2010, Vermont,Windham County,50025,2010,44513,42412,43693,820
2010, Vermont,Chittenden County,50007,2010,156545,144752,153689,2856
2000, Vermont,Chittenden County,50007,2000,146571,139446,145010,1561
2000, Vermont,Rutland County,50021,2000,63400,62214,62958,442
2000, Vermont,Washington County,50023,2000,58039,56326,57307,732
2010, Vermont,Washington County,50023,2010,59534,57192,58539,995
2000, Vermont,Windham County,50025,2000,44216,42764,43723,493
2000, Vermont,Grand Isle County,50013,2000,6901,6722,6872,29
2000, Vermont,Franklin County,50011,2000,45417,43627,45147,270
2020, Vermont,Orange County,50017,2020,29277,26978,28800,477
2010, Vermont,Orange County,50017,2010,28936,28077,28654,282
2010, Vermont,Caledonia County,50005,2010,31227,30138,30896,331
2010, Vermont,Grand Isle County,50013,2010,6970,6641,6890,80
2000, Vermont,Lamoille County,50015,2000,23233,22608,23053,180
2020, Vermont,Lamoille County,50015,2020,25945,23778,25294,651
2000, Vermont,Caledonia County,50005,2000,29702,28954,29501,201
2020, Vermont,Orleans County,50019,2020,27393,25464,26931,462
2000, Vermont,Orleans County,50019,2000,26277,25532,26087,190
2020, Vermont,Caledonia County,50005,2020,30233,27656,29628,605
2020, Vermont,Grand Isle County,50013,2020,7293,6724,7166,127
2010, Vermont,Orleans County,50019,2010,27231,26310,26926,305
2000, Vermont,Orange County,50017,2000,28226,27666,28061,165
2010, Virginia,Amherst County,51009,2010,32353,24829,31728,625
2020, Virginia,Arlington County,51013,2020,238643,145293,201281,37362
2010, Virginia,Arlington County,51013,2010,207627,148970,176245,31382
2000, Virginia,Amherst County,51009,2000,31894,24772,31588,306
2010, Virginia,Radford city,51750,2010,16408,14273,16023,385
2020, Virginia,Patrick County,51141,2020,17608,15719,17041,567
2020, Virginia,Brunswick County,51025,2020,15849,6553,15462,387
2010, Virginia,Brunswick County,51025,2010,17434,7048,17136,298
2020, Virginia,Danville city,51590,2020,42590,17262,40516,2074
2000, Virginia,Radford city,51750,2000,15859,13990,15675,184
2020, Virginia,Surry County,51181,2020,6561,3483,6412,149
2010, Virginia,Surry County,51181,2010,7058,3618,6972,86
2010, Virginia,Sussex County,51183,2010,12087,4747,11819,268
2000, Virginia,Hampton city,51650,2000,146437,72556,142284,4153
2020, Virginia,Sussex County,51183,2020,10829,4501,10523,306
2000, Virginia,Sussex County,51183,2000,12504,4550,12402,102
2020, Virginia,Covington city,51580,2020,5737,4585,5558,179
2000, Virginia,Covington city,51580,2000,6303,5298,6263,40
2010, Virginia,Covington city,51580,2010,5961,5014,5869,92
2000, Virginia,Craig County,51045,2000,5091,5037,5074,17
2000, Virginia,Surry County,51181,2000,6829,3201,6778,51
2000, Virginia,Warren County,51187,2000,31584,29280,31090,494
2010, Virginia,Buchanan County,51027,2010,24098,23271,24003,95
2010, Virginia,Warren County,51187,2010,37575,34144,36257,1318
2010, Virginia,Patrick County,51141,2010,18490,16847,18046,444
2000, Virginia,Roanoke city,51770,2000,94911,65848,93506,1405
2010, Virginia,Buena Vista city,51530,2010,6650,6050,6547,103
2020, Virginia,Buena Vista city,51530,2020,6641,5740,6412,229
2000, Virginia,Buckingham County,51029,2000,15623,9235,15497,126
2020, Virginia,Buckingham County,51029,2020,16824,10488,16411,413
2010, Virginia,Buckingham County,51029,2010,17146,10644,16858,288
2010, Virginia,Roanoke city,51770,2010,97032,62343,91687,5345
2000, Virginia,Virginia Beach city,51810,2000,425257,303681,407487,17770
2020, Virginia,Virginia Beach city,51810,2020,459470,278956,419066,40404
2020, Virginia,Warren County,51187,2020,40727,34386,38314,2413
2020, Virginia,Buchanan County,51027,2020,20355,19299,20178,177
2010, Virginia,Virginia Beach city,51810,2010,437994,296670,409007,28987
2020, Virginia,Radford city,51750,2020,16070,12280,15305,765
2000, Virginia,Arlington County,51013,2000,189453,130601,154185,35268
2010, Virginia,Henry County,51089,2010,54151,39487,51606,2545
2000, Virginia,Henry County,51089,2000,57930,43118,55928,2002
2020, Virginia,Henrico County,51087,2020,334389,170651,312304,22085
2010, Virginia,Henrico County,51087,2010,306935,181719,291934,15001
2000, Virginia,Henrico County,51087,2000,262300,180761,256354,5946
2000, Virginia,Buchanan County,51027,2000,26978,26101,26850,128
2000, Virginia,Brunswick County,51025,2000,18419,7734,18188,231
2020, Virginia,Henry County,51089,2020,50948,35040,47647,3301
2020, Virginia,Hampton city,51650,2020,137148,51202,128737,8411
2020, Virginia,Montgomery County,51121,2020,99721,79436,95070,4651
2020, Virginia,Craig County,51045,2020,4892,4653,4839,53
2000, Virginia,Culpeper County,51047,2000,34262,26816,33404,858
2010, Virginia,Cumberland County,51049,2010,10052,6427,9871,181
2000, Virginia,Hanover County,51085,2000,86320,76242,85473,847
2000, Virginia,Cumberland County,51049,2000,9017,5444,8867,150
2020, Virginia,Cumberland County,51049,2020,9675,6165,9434,241
2020, Virginia,Rockbridge County,51163,2020,22650,20483,22137,513
2010, Virginia,Hanover County,51085,2010,99863,86550,97747,2116
2010, Virginia,Appomattox County,51011,2010,14973,11597,14806,167
2000, Virginia,King and Queen County,51097,2000,6630,4059,6572,58
2020, Virginia,King and Queen County,51097,2020,6608,4490,6426,182
2010, Virginia,Rockbridge County,51163,2010,22307,21097,22011,296
2010, Virginia,King and Queen County,51097,2010,6945,4663,6761,184
2000, Virginia,Spotsylvania County,51177,2000,90395,74924,87859,2536
2020, Virginia,Spotsylvania County,51177,2020,140032,90227,123378,16654
2000, Virginia,Rockbridge County,51163,2000,20808,19856,20688,120
2010, Virginia,Bristol city,51520,2010,17835,16214,17614,221
2000, Virginia,Bristol city,51520,2000,17367,16072,17198,169
2010, Virginia,Spotsylvania County,51177,2010,122397,92452,113119,9278
2020, Virginia,Bristol city,51520,2020,17219,14754,16764,455
2000, Virginia,Danville city,51590,2000,48411,26075,47799,612
2020, Virginia,Petersburg city,51730,2020,33458,5418,31488,1970
2010, Virginia,Danville city,51590,2010,43055,20531,41810,1245
2010, Virginia,Petersburg city,51730,2010,32420,5217,31204,1216
2020, Virginia,Culpeper County,51047,2020,52552,36092,45043,7509
2000, Virginia,Gloucester County,51073,2000,34780,30148,34220,560
2000, Virginia,Appomattox County,51011,2000,13705,10408,13640,65
2010, Virginia,Southampton County,51175,2010,18570,11215,18367,203
2010, Virginia,Montgomery County,51121,2010,94392,82643,91856,2536
2000, Virginia,Petersburg city,51730,2000,33740,6249,33277,463
2000, Virginia,Patrick County,51141,2000,19407,17805,19044,363
2010, Virginia,Rockingham County,51165,2010,76314,71182,72238,4076
2000, Virginia,Montgomery County,51121,2000,83629,75270,82308,1321
2000, Virginia,Harrisonburg city,51660,2000,40468,34334,36888,3580
2020, Virginia,Harrisonburg city,51660,2020,51814,33789,39769,12045
2020, Virginia,Middlesex County,51119,2020,10625,8411,10366,259
2010, Virginia,Middlesex County,51119,2010,10959,8680,10793,166
2000, Virginia,Middlesex County,51119,2000,9932,7797,9877,55
2010, Virginia,Harrisonburg city,51660,2010,48914,38371,41249,7665
2010, Virginia,Craig County,51045,2010,5190,5122,5154,36
2000, Virginia,Rockingham County,51165,2000,67725,65406,65504,2221
2020, Virginia,King George County,51099,2020,26723,19121,25141,1582
2000, Virginia,King George County,51099,2000,16803,13055,16502,301
2010, Virginia,King George County,51099,2010,23584,18089,22794,790
2020, Virginia,Appomattox County,51011,2020,16119,12258,15775,344
2010, Virginia,King William County,51101,2010,15935,12297,15611,324
2010, Virginia,Hampton city,51650,2010,137436,58642,131195,6241
2000, Virginia,Southampton County,51175,2000,17482,9783,17367,115
2020, Virginia,King William County,51101,2020,17810,13636,17334,476
2010, Virginia,Culpeper County,51047,2010,46689,35058,42532,4157
2000, Virginia,King William County,51101,2000,13146,9703,13026,120
2020, Virginia,Southampton County,51175,2020,17996,11080,17664,332
2020, Virginia,Rockingham County,51165,2020,83757,72656,76664,7093
2020, Virginia,Gloucester County,51073,2020,38711,32396,37301,1410
2020, Virginia,New Kent County,51127,2020,22945,18017,22214,731
2000, Virginia,Buena Vista city,51530,2000,6349,5940,6285,64
2000, Virginia,Charles City County,51036,2000,6926,2470,6881,45
2010, Virginia,Charles City County,51036,2010,7256,2970,7168,88
2000, Virginia,Westmoreland County,51193,2000,16718,10936,16139,579
2000, Virginia,Staunton city,51790,2000,23853,19866,23588,265
2010, Virginia,Charlotte County,51037,2010,12586,8467,12346,240
2000, Virginia,Charlotte County,51037,2000,12472,8171,12266,206
2020, Virginia,Charlotte County,51037,2020,11529,7717,11276,253
2000, Virginia,Charlottesville city,51540,2000,45049,31337,43947,1102
2010, Virginia,Charlottesville city,51540,2010,43475,30031,41252,2223
2020, Virginia,Charlottesville city,51540,2020,46553,30344,43346,3207
2020, Virginia,Staunton city,51790,2020,25750,20207,24662,1088
2010, Virginia,Staunton city,51790,2010,23746,19874,23233,513
2020, Virginia,Charles City County,51036,2020,6773,3028,6672,101
2000, Virginia,Page County,51139,2000,23177,22311,22926,251
2010, Virginia,Page County,51139,2010,24042,23063,23669,373
2020, Virginia,Page County,51139,2020,23709,22037,23212,497
2000, Virginia,Chesapeake city,51550,2000,199184,133193,195108,4076
2020, Virginia,Chesapeake city,51550,2020,249422,139573,231598,17824
2010, Virginia,Chesapeake city,51550,2010,222209,139012,212503,9706
2020, Virginia,Nottoway County,51135,2020,15642,8625,14869,773
2010, Virginia,Nottoway County,51135,2010,15853,8968,15244,609
2010, Virginia,Chesterfield County,51041,2010,316236,215954,293372,22864
2000, Virginia,Chesterfield County,51041,2000,259903,199447,252286,7617
2020, Virginia,Chesterfield County,51041,2020,364548,216290,324312,40236
2000, Virginia,Nottoway County,51135,2000,15725,8988,15477,248
2010, Virginia,Norton city,51720,2010,3958,3510,3890,68
2010, Virginia,James City County,51095,2010,67009,53792,63985,3024
2010, Virginia,Westmoreland County,51193,2010,17454,11501,16452,1002
2020, Virginia,Westmoreland County,51193,2020,18477,11941,17428,1049
2020, Virginia,Russell County,51167,2020,25781,24835,25613,168
2000, Virginia,Campbell County,51031,2000,51078,42516,50655,423
2010, Virginia,Campbell County,51031,2010,54842,45024,53924,918
2020, Virginia,Campbell County,51031,2020,55696,43320,53881,1815
2010, Virginia,Isle of Wight County,51093,2010,35270,25318,34612,658
2010, Virginia,Accomack County,51001,2010,33164,21662,30314,2850
2000, Virginia,Isle of Wight County,51093,2000,29728,21130,29474,254
2020, Virginia,Isle of Wight County,51093,2020,38606,26721,37407,1199
2010, Virginia,Orange County,51137,2010,33481,27584,32342,1139
2020, Virginia,Orange County,51137,2020,36254,27877,34083,2171
2000, Virginia,Caroline County,51033,2000,22121,13842,21826,295
2020, Virginia,Caroline County,51033,2020,30887,19215,28919,1968
2010, Virginia,Rappahannock County,51157,2010,7373,6834,7145,228
2000, Virginia,Orange County,51137,2000,25881,21833,25551,330
2020, Virginia,Rappahannock County,51157,2020,7348,6521,7059,289
2010, Virginia,Waynesboro city,51820,2010,21006,17274,19669,1337
2020, Virginia,Waynesboro city,51820,2020,22196,16562,20251,1945
2000, Virginia,Waynesboro city,51820,2000,19520,16877,18877,643
2020, Virginia,Accomack County,51001,2020,33413,20261,29983,3430
2000, Virginia,Accomack County,51001,2000,38305,24276,36243,2062
2010, Virginia,Caroline County,51033,2010,28545,18649,27586,959
2000, Virginia,James City County,51095,2000,48102,39467,47286,816
2020, Virginia,Carroll County,51035,2020,29155,27255,28113,1042
2010, Virginia,Carroll County,51035,2010,30042,29168,29266,776
2000, Virginia,Carroll County,51035,2000,29245,28651,28766,479
2020, Virginia,James City County,51095,2020,78254,57710,73055,5199
2000, Virginia,Russell County,51167,2000,30308,29118,30071,237
2010, Virginia,Russell County,51167,2010,28897,28270,28622,275
2000, Virginia,Norton city,51720,2000,3904,3575,3870,34
2020, Virginia,Amherst County,51009,2020,31307,23190,30469,838
2000, Virginia,Rappahannock County,51157,2000,6983,6469,6892,91
2000, Virginia,Washington County,51191,2000,51103,49854,50781,322
2000, Virginia,Hopewell city,51670,2000,22354,13924,21703,651
2000, Virginia,Clifton Forge city,51560,2000,4289,3558,4251,38
2020, Virginia,Alexandria city,51510,2020,159467,82185,130095,29372
2000, Virginia,Alexandria city,51510,2000,128283,76702,109401,18882
2010, Virginia,Alexandria city,51510,2010,139966,85186,117442,22524
2000, Virginia,Newport News city,51700,2000,180150,96383,172555,7595
2020, Virginia,Newport News city,51700,2020,186247,74676,166959,19288
2010, Virginia,Newport News city,51700,2010,180719,88518,167129,13590
2000, Virginia,New Kent County,51127,2000,13462,10805,13286,176
2020, Virginia,Roanoke city,51770,2020,100011,57309,91527,8484
2010, Virginia,New Kent County,51127,2010,18429,15057,18039,390
2020, Virginia,Nelson County,51125,2020,14775,12021,14112,663
2010, Virginia,Hopewell city,51670,2010,22591,12515,21111,1480
2010, Virginia,Nelson County,51125,2010,15020,12509,14561,459
2000, Virginia,Nelson County,51125,2000,14445,11939,14140,305
2020, Virginia,Alleghany County,51005,2020,15223,13813,15045,178
2010, Virginia,Alleghany County,51005,2010,16250,15145,16074,176
2000, Virginia,Alleghany County,51005,2000,12926,12454,12879,47
2010, Virginia,Highland County,51091,2010,2321,2289,2303,18
2020, Virginia,Highland County,51091,2020,2232,2135,2197,35
2010, Virginia,Amelia County,51007,2010,12690,9332,12400,290
2000, Virginia,Amelia County,51007,2000,11400,8045,11309,91
2020, Virginia,Amelia County,51007,2020,13265,9780,12840,425
2000, Virginia,Colonial Heights city,51570,2000,16897,15052,16623,274
2020, Virginia,Colonial Heights city,51570,2020,18170,12652,16894,1276
2010, Virginia,Colonial Heights city,51570,2010,17411,14326,16737,674
2000, Virginia,Highland County,51091,2000,2536,2517,2523,13
2020, Virginia,Hopewell city,51670,2020,23033,10141,21144,1889
2020, Virginia,Suffolk city,51800,2020,94324,44723,90072,4252
2010, Virginia,Suffolk city,51800,2010,84585,44197,82170,2415
2010, Virginia,Washington County,51191,2010,54876,53249,54152,724
2000, Virginia,Stafford County,51179,2000,92446,75807,89104,3342
2010, Virginia,Stafford County,51179,2010,128961,93483,117086,11875
2020, Virginia,Stafford County,51179,2020,156927,90269,133281,23646
2020, Virginia,Norton city,51720,2020,3687,3242,3606,81
2020, Virginia,Northumberland County,51133,2020,11839,8366,11488,351
2010, Virginia,Northumberland County,51133,2010,12330,8801,11948,382
2000, Virginia,Northumberland County,51133,2000,12259,8849,12145,114
2000, Virginia,Northampton County,51131,2000,13093,6977,12639,454
2020, Virginia,Northampton County,51131,2020,12282,7071,11214,1068
2010, Virginia,Northampton County,51131,2010,12389,7168,11515,874
2010, Virginia,Norfolk city,51710,2010,242803,114304,226659,16144
2020, Virginia,Norfolk city,51710,2020,238005,102841,214875,23130
2000, Virginia,Norfolk city,51710,2000,234403,113358,225488,8915
2020, Virginia,York County,51199,2020,70045,48251,64909,5136
2000, Virginia,York County,51199,2000,56297,45038,54788,1509
2010, Virginia,York County,51199,2010,65464,50031,62572,2892
2020, Virginia,Clarke County,51043,2020,14783,12481,13896,887
2010, Virginia,Clarke County,51043,2010,14034,12662,13544,490
2000, Virginia,Clarke County,51043,2000,12652,11532,12467,185
2020, Virginia,Salem city,51775,2020,25346,20923,24258,1088
2000, Virginia,Salem city,51775,2000,24747,22738,24542,205
2010, Virginia,Salem city,51775,2010,24802,21872,24201,601
2000, Virginia,Albemarle County,51003,2000,79236,67474,77207,2029
2020, Virginia,Albemarle County,51003,2020,112395,81866,103942,8453
2010, Virginia,Albemarle County,51003,2010,98970,79738,93553,5417
2000, Virginia,Suffolk city,51800,2000,63677,34271,62868,809
2020, Virginia,Washington County,51191,2020,53935,50639,53044,891
2020, Virginia,Roanoke County,51161,2020,96929,80780,93422,3507
2020, Virginia,Hanover County,51085,2020,109979,89742,106041,3938
2010, Virginia,Manassas Park city,51685,2010,14273,7985,9628,4645
2020, Virginia,Franklin County,51067,2020,54477,46702,52522,1955
2000, Virginia,Franklin County,51067,2000,47286,42063,46713,573
2010, Virginia,Franklin County,51067,2010,56159,49699,54735,1424
2000, Virginia,Louisa County,51109,2000,25627,19617,25445,182
2020, Virginia,Louisa County,51109,2020,37596,28813,36231,1365
2010, Virginia,Prince George County,51149,2010,35725,21845,33667,2058
2010, Virginia,Emporia city,51595,2010,5927,1937,5665,262
2000, Virginia,Emporia city,51595,2000,5665,2405,5581,84
2020, Virginia,Prince George County,51149,2020,43010,23827,38666,4344
2020, Virginia,Emporia city,51595,2020,5766,1544,5421,345
2000, Virginia,Pulaski County,51155,2000,35127,32529,34791,336
2010, Virginia,Pulaski County,51155,2010,34872,32250,34440,432
2020, Virginia,Pulaski County,51155,2020,33800,29922,33096,704
2000, Virginia,Essex County,51057,2000,9989,5790,9917,72
2020, Virginia,Essex County,51057,2020,10599,5952,10230,369
2010, Virginia,Essex County,51057,2010,11151,6370,10802,349
2000, Virginia,Fairfax County,51059,2000,969749,677904,862791,106958
2020, Virginia,Fairfax County,51059,2020,1150309,569013,951075,199234
2010, Virginia,Fairfax County,51059,2010,1081726,677990,913244,168482
2000, Virginia,Fairfax city,51600,2000,21498,15675,18566,2932
2020, Virginia,Fairfax city,51600,2020,24146,13473,19868,4278
2020, Virginia,Greene County,51079,2020,20552,16520,19222,1330
2010, Virginia,Fairfax city,51600,2010,22565,15706,19009,3556
2000, Virginia,Greene County,51079,2000,15244,13871,15043,201
2010, Virginia,Greene County,51079,2010,18403,16123,17622,781
2010, Virginia,Louisa County,51109,2010,33153,25996,32391,762
2020, Virginia,Frederick County,51069,2020,91419,73524,81429,9990
2000, Virginia,Augusta County,51015,2000,65615,62347,64995,620
2020, Virginia,Augusta County,51015,2020,77487,69142,74759,2728
2010, Virginia,Frederick County,51069,2010,78305,69934,73137,5168
2010, Virginia,Martinsville city,51690,2010,13821,6903,13269,552
2010, Virginia,Poquoson city,51735,2010,12150,11557,11929,221
2000, Virginia,Franklin city,51620,2000,8346,3816,8300,46
2020, Virginia,Martinsville city,51690,2020,13485,5924,12460,1025
2020, Virginia,Wythe County,51197,2020,28290,26165,27935,355
2010, Virginia,Wythe County,51197,2010,29235,27790,28955,280
2010, Virginia,Scott County,51169,2010,23177,22700,22943,234
2000, Virginia,Scott County,51169,2000,23403,23055,23304,99
2020, Virginia,Scott County,51169,2020,21576,20617,21321,255
2020, Virginia,Franklin city,51620,2020,8180,3008,7962,218
2010, Virginia,Franklin city,51620,2010,8582,3380,8441,141
2000, Virginia,Wythe County,51197,2000,27599,26429,27442,157
2020, Virginia,Portsmouth city,51740,2020,97915,35892,93502,4413
2020, Virginia,Greensville County,51081,2020,11391,4364,11115,276
2010, Virginia,Greensville County,51081,2010,12243,4718,12070,173
2000, Virginia,Greensville County,51081,2000,11560,4502,11452,108
2000, Virginia,Portsmouth city,51740,2000,100565,46096,98817,1748
2010, Virginia,Portsmouth city,51740,2010,95535,39701,92616,2919
2000, Virginia,Richmond city,51760,2000,197790,75744,192716,5074
2000, Virginia,Bland County,51021,2000,6871,6515,6839,32
2000, Virginia,Fluvanna County,51065,2000,20047,15925,19812,235
2020, Virginia,Fluvanna County,51065,2020,27249,21023,26142,1107
2010, Virginia,Fluvanna County,51065,2010,25691,20743,24931,760
2000, Virginia,Grayson County,51077,2000,17917,16429,17640,277
2010, Virginia,Grayson County,51077,2010,15533,14802,15117,416
2000, Virginia,Lee County,51105,2000,23589,23221,23469,120
2020, Virginia,Floyd County,51063,2020,15476,14219,14989,487
2010, Virginia,Floyd County,51063,2010,15279,14660,14867,412
2010, Virginia,Lynchburg city,51680,2010,75568,48674,73268,2300
2020, Virginia,Lynchburg city,51680,2020,79009,48502,75129,3880
2000, Virginia,Richmond County,51159,2000,8809,5706,8624,185
2000, Virginia,Floyd County,51063,2000,13874,13418,13687,187
2000, Virginia,Lunenburg County,51111,2000,13146,7772,12911,235
2000, Virginia,Poquoson city,51735,2000,11566,11134,11444,122
2020, Virginia,Lee County,51105,2020,22173,20531,21697,476
2010, Virginia,Wise County,51195,2010,41452,38561,40981,471
2020, Virginia,Wise County,51195,2020,36130,32789,35678,452
2000, Virginia,Wise County,51195,2000,40123,38870,39831,292
2020, Virginia,Poquoson city,51735,2020,12460,11059,11997,463
2010, Virginia,Lunenburg County,51111,2010,12914,7856,12444,470
2010, Virginia,Richmond County,51159,2010,9254,6001,8744,510
2020, Virginia,Lunenburg County,51111,2020,11936,7095,11347,589
2010, Virginia,Lee County,51105,2010,25587,24092,25181,406
2020, Virginia,Richmond County,51159,2020,8923,5739,8326,597
2010, Virginia,Richmond city,51760,2010,204214,83288,191411,12803
2020, Virginia,Bland County,51021,2020,6270,5874,6210,60
2020, Virginia,Falls Church city,51610,2020,14658,10221,13129,1529
2010, Virginia,Falls Church city,51610,2010,12332,9853,11223,1109
2000, Virginia,Falls Church city,51610,2000,10377,8817,9501,876
2010, Virginia,Bland County,51021,2010,6824,6517,6785,39
2010, Virginia,Manassas city,51683,2010,37821,23336,25945,11876
2000, Virginia,Manassas city,51683,2000,35135,25316,29819,5316
2020, Virginia,Manassas city,51683,2020,42772,16717,24427,18345
2020, Virginia,Manassas Park city,51685,2020,17219,5535,9420,7799
2000, Virginia,Manassas Park city,51685,2000,10290,7490,8746,1544
2010, Virginia,Winchester city,51840,2010,26203,19532,22162,4041
2020, Virginia,Madison County,51113,2020,13837,11684,13396,441
2000, Virginia,Fauquier County,51061,2000,55139,48740,54025,1114
2020, Virginia,Fauquier County,51061,2020,72972,56660,65179,7793
2010, Virginia,Fauquier County,51061,2010,65203,55607,61025,4178
2010, Virginia,Prince William County,51153,2010,402002,232401,320542,81460
2020, Virginia,Prince William County,51153,2020,482204,200831,360680,121524
2000, Virginia,Prince William County,51153,2000,280813,193574,253475,27338
2010, Virginia,Madison County,51113,2010,13308,11543,13072,236
2000, Virginia,Prince George County,51149,2000,33047,20135,31422,1625
2020, Virginia,Grayson County,51077,2020,15333,13558,14737,596
2020, Virginia,Richmond city,51760,2020,226610,98140,202863,23747
2000, Virginia,Madison County,51113,2000,12520,10856,12424,96
2000, Virginia,Loudoun County,51107,2000,169599,140419,159510,10089
2000, Virginia,Martinsville city,51690,2000,15416,8537,15058,358
2000, Virginia,Frederick County,51069,2000,59209,56240,58205,1004
2000, Virginia,Giles County,51071,2000,16657,16226,16552,105
2020, Virginia,Williamsburg city,51830,2020,15425,7572,14210,1215
2010, Virginia,Roanoke County,51161,2010,92376,83140,90425,1951
2020, Virginia,Giles County,51071,2020,16787,15777,16543,244
2010, Virginia,Giles County,51071,2010,17286,16723,17077,209
2020, Virginia,Bath County,51017,2020,4209,3855,4136,73
2020, Virginia,Prince Edward County,51147,2020,21849,10662,20761,1088
2000, Virginia,Bedford County,51019,2000,60371,55649,59922,449
2020, Virginia,Bedford County,51019,2020,79462,68743,77407,2055
2010, Virginia,Bedford County,51019,2010,68676,62775,67586,1090
2000, Virginia,Bedford city,51515,2000,6299,4745,6243,56
2010, Virginia,Bedford city,51515,2010,6222,4755,6088,134
2020, Virginia,Botetourt County,51023,2020,33596,30689,32820,776
2000, Virginia,Lexington city,51678,2000,6867,5906,6758,109
2000, Virginia,Botetourt County,51023,2000,30496,28944,30315,181
2010, Virginia,Botetourt County,51023,2010,33148,31469,32792,356
2020, Virginia,Loudoun County,51107,2020,420959,225974,361215,59744
2010, Virginia,Lexington city,51678,2010,7042,6003,6771,271
2020, Virginia,Lexington city,51678,2020,7320,6112,6985,335
2010, Virginia,Prince Edward County,51147,2010,23368,14796,22843,525
2010, Virginia,Shenandoah County,51171,2010,41993,39070,39416,2577
2000, Virginia,Bath County,51017,2000,5048,4659,5030,18
2020, Virginia,Shenandoah County,51171,2020,44186,38166,40460,3726
2000, Virginia,Williamsburg city,51830,2000,11998,9543,11696,302
2000, Virginia,Roanoke County,51161,2000,85778,80312,84890,888
2020, Virginia,Dickenson County,51051,2020,14124,13728,14041,83
2010, Virginia,Gloucester County,51073,2010,36858,32149,35923,935
2020, Virginia,Goochland County,51075,2020,24727,19302,23865,862
2010, Virginia,Bath County,51017,2010,4731,4432,4630,101
2010, Virginia,Dickenson County,51051,2010,15903,15712,15817,86
2000, Virginia,Prince Edward County,51147,2000,19720,12260,19534,186
2000, Virginia,Dickenson County,51051,2000,16395,16224,16325,70
2010, Virginia,Goochland County,51075,2010,21717,16820,21262,455
2000, Virginia,Mecklenburg County,51117,2000,32380,19181,31987,393
2010, Virginia,Mecklenburg County,51117,2010,32727,19619,31921,806
2020, Virginia,Mecklenburg County,51117,2020,30319,18032,29498,821
2000, Virginia,Goochland County,51075,2000,16863,12261,16719,144
2000, Virginia,Tazewell County,51185,2000,44598,42886,44370,228
2020, Virginia,Tazewell County,51185,2020,40429,37528,39922,507
2010, Virginia,Tazewell County,51185,2010,45078,42868,44782,296
2020, Virginia,Halifax County,51083,2020,34022,20420,33262,760
2010, Virginia,Halifax County,51083,2010,36241,22011,35654,587
2000, Virginia,Halifax County,51083,2000,37355,22531,36897,458
2020, Virginia,Dinwiddie County,51053,2020,27947,17516,26819,1128
2000, Virginia,Dinwiddie County,51053,2000,24533,15837,24296,237
2010, Virginia,Dinwiddie County,51053,2010,28001,17899,27327,674
2010, Virginia,Williamsburg city,51830,2010,14068,10407,13127,941
2020, Virginia,Galax city,51640,2020,6720,5233,5659,1061
2000, Virginia,Lynchburg city,51680,2000,65269,43487,64391,878
2010, Virginia,Powhatan County,51145,2010,28046,23515,27544,502
2010, Virginia,Lancaster County,51103,2010,11391,7989,11273,118
2010, Virginia,Mathews County,51115,2010,8978,7898,8874,104
2020, Virginia,Mathews County,51115,2020,8533,7295,8336,197
2000, Virginia,Powhatan County,51145,2000,22377,18237,22193,184
2000, Virginia,Shenandoah County,51171,2000,35075,33533,33881,1194
2020, Virginia,Lancaster County,51103,2020,10919,7467,10794,125
2010, Virginia,Pittsylvania County,51143,2010,63506,47918,62174,1332
2000, Virginia,Pittsylvania County,51143,2000,61745,46311,60986,759
2010, Virginia,Augusta County,51015,2010,73750,68848,72225,1525
2010, Virginia,Galax city,51640,2010,7042,6044,6053,989
2020, Virginia,Powhatan County,51145,2020,30333,25732,29541,792
2010, Virginia,Smyth County,51173,2010,32208,30847,31681,527
2020, Virginia,Smyth County,51173,2020,29800,27939,29242,558
2000, Virginia,Smyth County,51173,2000,33081,32043,32798,283
2000, Virginia,Lancaster County,51103,2000,11567,8091,11496,71
2000, Virginia,Mathews County,51115,2000,9207,8038,9134,73
2020, Virginia,Winchester city,51840,2020,28120,18336,22626,5494
2010, Virginia,Loudoun County,51107,2010,312311,214471,273735,38576
2010, Virginia,Fredericksburg city,51630,2010,24286,15596,21679,2607
2020, Virginia,Fredericksburg city,51630,2020,27982,15872,24510,3472
2000, Virginia,Fredericksburg city,51630,2000,19279,14108,18334,945
2020, Virginia,Pittsylvania County,51143,2020,60501,44672,58789,1712
2000, Virginia,Galax city,51640,2000,6837,5887,6080,757
2000, Virginia,Winchester city,51840,2000,23585,19355,22058,1527
2010, Washington,Lincoln County,53043,2010,10570,10038,10331,239
2010, Washington,Clallam County,53009,2010,71404,62092,67777,3627
2020, Washington,Clallam County,53009,2020,77155,62450,72423,4732
2000, Washington,Lewis County,53041,2000,68600,63772,64916,3684
2000, Washington,Pacific County,53049,2000,20984,18998,19932,1052
2000, Washington,Chelan County,53007,2000,66616,55711,53785,12831
2000, Washington,Grant County,53025,2000,74698,57174,52222,22476
2020, Washington,Lincoln County,53043,2020,10876,9704,10491,385
2010, Washington,Adams County,53001,2010,18728,11703,7629,11099
2020, Washington,Island County,53029,2020,86857,67928,79739,7118
2020, Washington,Grant County,53025,2020,99123,57433,56722,42401
2010, Washington,Grant County,53025,2010,89120,64906,54957,34163
2010, Washington,Island County,53029,2010,78506,67611,74211,4295
2000, Washington,Island County,53029,2000,71558,62374,68715,2843
2010, Washington,Chelan County,53007,2010,72453,57484,53740,18713
2020, Washington,Adams County,53001,2020,20613,9164,7493,13120
2020, Washington,Chelan County,53007,2020,79074,55289,56970,22104
2010, Washington,Lewis County,53041,2010,75455,67712,68928,6527
2000, Washington,Benton County,53005,2000,142475,122879,124669,17806
2020, Washington,Benton County,53005,2020,206873,146087,157534,49339
2000, Washington,Adams County,53001,2000,16428,10672,8696,7732
2020, Washington,Okanogan County,53047,2020,42104,27606,33907,8197
2010, Washington,Okanogan County,53047,2010,41120,30399,33893,7227
2010, Washington,Pacific County,53049,2010,20920,18286,19243,1677
2000, Washington,Okanogan County,53047,2000,39564,29799,33876,5688
2000, Washington,Garfield County,53023,2000,2397,2312,2350,47
2010, Washington,Stevens County,53065,2010,43531,38923,42346,1185
2000, Washington,Whatcom County,53073,2000,166814,147485,158127,8687
2020, Washington,Whatcom County,53073,2020,226847,175946,204022,22825
2020, Washington,Franklin County,53021,2020,96749,45837,44304,52445
2010, Washington,Whatcom County,53073,2010,201140,171816,185384,15756
2020, Washington,Garfield County,53023,2020,2286,2098,2176,110
2020, Washington,Stevens County,53065,2020,46445,39313,44760,1685
2000, Washington,Franklin County,53021,2000,49347,30553,26315,23032
2010, Washington,Franklin County,53021,2010,78163,47270,38159,40004
2010, Washington,Benton County,53005,2010,175177,144418,142481,32696
2020, Washington,Pacific County,53049,2020,23365,19104,21169,2196
2020, Washington,Lewis County,53041,2020,82149,67825,73319,8830
2010, Washington,Jefferson County,53031,2010,29872,27198,29024,848
2020, Washington,Jefferson County,53031,2020,32977,28588,31672,1305
2000, Washington,Lincoln County,53043,2000,10184,9740,9993,191
2000, Washington,Jefferson County,53031,2000,25953,23920,25418,535
2010, Washington,Garfield County,53023,2010,2266,2125,2175,91
2000, Washington,Stevens County,53065,2000,40066,36078,39327,739
2020, Washington,Yakima County,53077,2020,256728,124445,126679,130049
2020, Washington,Clark County,53011,2020,503311,379827,444521,58790
2010, Washington,Walla Walla County,53071,2010,58781,49654,47188,11593
2010, Washington,Douglas County,53017,2010,38431,30573,27418,11013
2000, Washington,Douglas County,53017,2000,32603,27599,26170,6433
2020, Washington,Douglas County,53017,2020,42938,27842,28301,14637
2000, Washington,Snohomish County,53061,2000,606024,518948,577434,28590
2000, Washington,Pend Oreille County,53051,2000,11732,10973,11491,241
2020, Washington,Pend Oreille County,53051,2020,13401,11811,12953,448
2010, Washington,Pend Oreille County,53051,2010,13001,11907,12610,391
2010, Washington,Skamania County,53059,2010,11066,10265,10513,553
2020, Washington,Skamania County,53059,2020,12036,10308,11271,765
2000, Washington,Skamania County,53059,2000,9872,9093,9474,398
2010, Washington,Mason County,53045,2010,60699,52281,55855,4844
2010, Washington,King County,53033,2010,1931249,1325845,1758871,172378
2000, Washington,Clallam County,53009,2000,64525,57505,62322,2203
2020, Washington,King County,53033,2020,2269675,1273054,2026654,243021
2020, Washington,Whitman County,53075,2020,47973,36586,43921,4052
2000, Washington,Whitman County,53075,2000,40740,35880,39521,1219
2000, Washington,King County,53033,2000,1737034,1315507,1641792,95242
2020, Washington,Mason County,53045,2020,65726,51023,58131,7595
2010, Washington,Whitman County,53075,2010,44776,37866,42736,2040
2020, Washington,San Juan County,53055,2020,17788,15276,16490,1298
2000, Washington,Walla Walla County,53071,2000,55180,47081,46526,8654
2020, Washington,Walla Walla County,53071,2020,62584,45471,48378,14206
2010, Washington,Snohomish County,53061,2010,713335,559011,649086,64249
2000, Washington,Spokane County,53063,2000,417939,381934,406378,11561
2000, Washington,Yakima County,53077,2000,222581,146005,142676,79905
2000, Washington,Asotin County,53003,2000,20551,19650,20150,401
2010, Washington,Asotin County,53003,2010,21623,20392,20980,643
2000, Washington,Pierce County,53053,2000,700820,549369,662199,38621
2010, Washington,Yakima County,53077,2010,243231,155056,133761,109470
2020, Washington,Pierce County,53053,2020,921130,595446,809319,111811
2010, Washington,Pierce County,53053,2010,795225,590040,722376,72849
2020, Washington,Klickitat County,53039,2020,22735,18271,19822,2913
2010, Washington,Klickitat County,53039,2010,20318,17824,18147,2171
2000, Washington,Klickitat County,53039,2000,19161,16778,17665,1496
2010, Washington,Cowlitz County,53015,2010,102410,91069,94435,7975
2020, Washington,Wahkiakum County,53069,2020,4422,3884,4239,183
2010, Washington,Wahkiakum County,53069,2010,3978,3738,3870,108
2010, Washington,Kittitas County,53037,2010,40915,36544,37794,3121
2020, Washington,Kittitas County,53037,2020,44337,36479,39743,4594
2000, Washington,Kittitas County,53037,2000,33362,30617,31694,1668
2010, Washington,Kitsap County,53035,2010,251133,207369,235447,15686
2020, Washington,Kitsap County,53035,2020,275611,206398,251427,24184
2000, Washington,Kitsap County,53035,2000,231969,195481,222360,9609
2020, Washington,Spokane County,53063,2020,539339,442952,503989,35350
2020, Washington,Snohomish County,53061,2020,827957,546855,732313,95644
2010, Washington,Spokane County,53063,2010,471221,420275,449961,21260
2000, Washington,Wahkiakum County,53069,2000,3824,3574,3726,98
2000, Washington,Cowlitz County,53015,2000,92948,85326,88717,4231
2000, Washington,Mason County,53045,2000,49405,43705,47044,2361
2020, Washington,Columbia County,53013,2020,3952,3442,3648,304
2020, Washington,Cowlitz County,53015,2020,110730,90812,99928,10802
2000, Washington,Columbia County,53013,2000,4064,3809,3806,258
2010, Washington,Columbia County,53013,2010,4078,3791,3824,254
2010, Washington,Thurston County,53067,2010,252264,207856,234477,17787
2000, Washington,Thurston County,53067,2000,207355,177617,197963,9392
2020, Washington,Thurston County,53067,2020,294793,215798,265769,29024
2000, Washington,Ferry County,53019,2000,7260,5480,7055,205
2010, Washington,Ferry County,53019,2010,7551,5758,7297,254
2020, Washington,Ferry County,53019,2020,7178,5118,6968,210
2000, Washington,Grays Harbor County,53027,2000,67194,59335,63936,3258
2020, Washington,Asotin County,53003,2020,22285,19858,21370,915
2010, Washington,Grays Harbor County,53027,2010,72797,61825,66525,6272
2020, Washington,Grays Harbor County,53027,2020,75636,59052,67802,7834
2010, Washington,Skagit County,53057,2010,116901,97448,97192,19709
2000, Washington,Skagit County,53057,2000,102979,89070,91443,11536
2010, Washington,Clark County,53011,2010,425363,363397,393197,32166
2000, Washington,Clark County,53011,2000,345238,306648,328990,16248
2010, Washington,San Juan County,53055,2010,15769,14597,14912,857
2020, Washington,Skagit County,53057,2020,129523,96540,105731,23792
2000, Washington,San Juan County,53055,2000,14077,13372,13739,338
2020, West Virginia,Braxton County,54007,2020,12447,11976,12362,85
2000, West Virginia,Berkeley County,54003,2000,75905,70392,74749,1156
2010, West Virginia,Calhoun County,54013,2010,7627,7504,7570,57
2000, West Virginia,Calhoun County,54013,2000,7582,7499,7540,42
2010, West Virginia,Ritchie County,54085,2010,10449,10308,10394,55
2000, West Virginia,Roane County,54087,2000,15446,15223,15342,104
2010, West Virginia,Roane County,54087,2010,14926,14682,14823,103
2010, West Virginia,Berkeley County,54003,2010,104169,91500,100208,3961
2000, West Virginia,Cabell County,54011,2000,96784,90370,96130,654
2010, West Virginia,Braxton County,54007,2010,14523,14259,14456,67
2000, West Virginia,Braxton County,54007,2000,14702,14411,14637,65
2020, West Virginia,Roane County,54087,2020,14028,13305,13876,152
2010, West Virginia,Cabell County,54011,2010,96319,88194,95273,1046
2010, West Virginia,Preston County,54077,2010,33520,32724,33291,229
2020, West Virginia,Preston County,54077,2020,34216,30832,33521,695
2020, West Virginia,Wirt County,54105,2020,5194,5013,5172,22
2000, West Virginia,Preston County,54077,2000,29334,28995,29166,168
2010, West Virginia,Wirt County,54105,2010,5717,5631,5691,26
2020, West Virginia,Berkeley County,54003,2020,122076,98281,115183,6893
2020, West Virginia,Cabell County,54011,2020,94350,82665,92788,1562
2000, West Virginia,Putnam County,54079,2000,51589,50542,51327,262
2000, West Virginia,Wirt County,54105,2000,5873,5788,5855,18
2000, West Virginia,Randolph County,54083,2000,28262,27609,28071,191
2010, West Virginia,Wetzel County,54103,2010,16583,16371,16500,83
2020, West Virginia,Calhoun County,54013,2020,6229,6003,6181,48
2010, West Virginia,Boone County,54005,2010,24629,24271,24532,97
2020, West Virginia,Barbour County,54001,2020,15465,14460,15273,192
2020, West Virginia,Pocahontas County,54075,2020,7869,7497,7762,107
2000, West Virginia,Pleasants County,54073,2000,7514,7386,7486,28
2020, West Virginia,Randolph County,54083,2020,27932,26144,27620,312
2010, West Virginia,Pleasants County,54073,2010,7605,7401,7544,61
2010, West Virginia,Randolph County,54083,2010,29405,28614,29213,192
2000, West Virginia,Raleigh County,54081,2000,79220,71006,78493,727
2020, West Virginia,Raleigh County,54081,2020,74591,64025,73394,1197
2020, West Virginia,Pleasants County,54073,2020,7653,7248,7590,63
2020, West Virginia,Boone County,54005,2020,21809,20780,21676,133
2020, West Virginia,Putnam County,54079,2020,57440,53364,56629,811
2010, West Virginia,Raleigh County,54081,2010,78859,69800,77863,996
2000, West Virginia,Wetzel County,54103,2000,17693,17502,17619,74
2020, West Virginia,Wetzel County,54103,2020,14442,13752,14294,148
2000, West Virginia,Boone County,54005,2000,25535,25160,25418,117
2010, West Virginia,Wood County,54107,2010,86956,83846,86212,744
2010, West Virginia,Putnam County,54079,2010,55486,53684,55002,484
2000, West Virginia,Barbour County,54001,2000,15557,15147,15484,73
2020, West Virginia,Wood County,54107,2020,84296,78170,83122,1174
2000, West Virginia,Wood County,54107,2000,87986,85627,87472,514
2000, West Virginia,Pocahontas County,54075,2000,9131,8983,9092,39
2000, West Virginia,Brooke County,54009,2000,25447,24913,25348,99
2020, West Virginia,Brooke County,54009,2020,22559,20915,22272,287
2010, West Virginia,Brooke County,54009,2010,24069,23358,23906,163
2010, West Virginia,Pocahontas County,54075,2010,8719,8528,8651,68
2000, West Virginia,Ritchie County,54085,2000,10343,10206,10294,49
2020, West Virginia,Ritchie County,54085,2020,8444,8155,8364,80
2020, West Virginia,Wyoming County,54109,2020,21382,20592,21212,170
2010, West Virginia,Pendleton County,54071,2010,7695,7402,7624,71
2000, West Virginia,Pendleton County,54071,2000,8196,7896,8123,73
2020, West Virginia,Pendleton County,54071,2020,6143,5845,6086,57
2010, West Virginia,Barbour County,54001,2010,16589,16059,16493,96
2010, West Virginia,Wyoming County,54109,2010,23796,23356,23691,105
2000, West Virginia,Wyoming County,54109,2000,25708,25345,25573,135
2020, West Virginia,Webster County,54101,2020,8378,8105,8328,50
2010, West Virginia,Taylor County,54091,2010,16895,16481,16752,143
2000, West Virginia,Webster County,54101,2000,9719,9639,9683,36
2000, West Virginia,Logan County,54045,2000,37710,36325,37508,202
2010, West Virginia,Logan County,54045,2010,36743,35475,36485,258
2000, West Virginia,Tucker County,54093,2000,7321,7237,7303,18
2020, West Virginia,McDowell County,54047,2020,19111,16195,18721,390
2010, West Virginia,Greenbrier County,54025,2010,35480,33565,35058,422
2020, West Virginia,Greenbrier County,54025,2020,32977,30360,32406,571
2000, West Virginia,Greenbrier County,54025,2000,34453,32810,34217,236
2000, West Virginia,McDowell County,54047,2000,27329,23792,27197,132
2000, West Virginia,Morgan County,54065,2000,14943,14689,14819,124
2010, West Virginia,Morgan County,54065,2010,17541,17063,17358,183
2020, West Virginia,Morgan County,54065,2020,17063,15985,16827,236
2000, West Virginia,Doddridge County,54017,2000,7403,7278,7361,42
2010, West Virginia,Tucker County,54093,2010,7141,7051,7100,41
2020, West Virginia,Taylor County,54091,2020,16705,15710,16526,179
2000, West Virginia,Taylor County,54091,2000,16089,15779,15994,95
2010, West Virginia,McDowell County,54047,2010,22113,19710,22022,91
2000, West Virginia,Nicholas County,54067,2000,26562,26255,26435,127
2010, West Virginia,Gilmer County,54021,2010,8693,7173,8200,493
2000, West Virginia,Clay County,54015,2000,10330,10146,10288,42
2020, West Virginia,Clay County,54015,2020,8051,7671,7999,52
2010, West Virginia,Clay County,54015,2010,9386,9271,9353,33
2020, West Virginia,Nicholas County,54067,2020,24604,23603,24431,173
2020, West Virginia,Mason County,54053,2020,25453,24401,25283,170
2010, West Virginia,Nicholas County,54067,2010,26233,25805,26087,146
2020, West Virginia,Tucker County,54093,2020,6762,6457,6706,56
2010, West Virginia,Doddridge County,54017,2010,8202,7955,8163,39
2020, West Virginia,Doddridge County,54017,2020,7808,7304,7731,77
2020, West Virginia,Grant County,54023,2020,10976,10489,10885,91
2000, West Virginia,Gilmer County,54021,2000,7160,6969,7110,50
2020, West Virginia,Gilmer County,54021,2020,7408,6220,7164,244
2000, West Virginia,Mercer County,54055,2000,62980,58295,62695,285
2010, West Virginia,Mercer County,54055,2010,62264,57009,61784,480
2020, West Virginia,Mercer County,54055,2020,59664,52554,58959,705
2010, West Virginia,Lincoln County,54043,2010,21720,21504,21624,96
2000, West Virginia,Lincoln County,54043,2000,22108,21895,21987,121
2020, West Virginia,Mineral County,54057,2020,26938,24734,26629,309
2010, West Virginia,Lewis County,54041,2010,16372,16029,16268,104
2010, West Virginia,Mineral County,54057,2010,28212,26890,28010,202
2000, West Virginia,Mineral County,54057,2000,27078,26037,26920,158
2010, West Virginia,Mingo County,54059,2010,26839,26048,26720,119
2020, West Virginia,Mingo County,54059,2020,23568,22383,23404,164
2000, West Virginia,Lewis County,54041,2000,16919,16681,16834,85
2020, West Virginia,Logan County,54045,2020,32567,30884,32343,224
2000, West Virginia,Mingo County,54059,2000,28253,27233,28118,135
2000, West Virginia,Monongalia County,54061,2000,81866,75500,81040,826
2020, West Virginia,Monongalia County,54061,2020,105822,90012,102514,3308
2010, West Virginia,Monongalia County,54061,2010,96189,87488,94497,1692
2010, West Virginia,Monroe County,54063,2010,13502,13162,13419,83
2000, West Virginia,Monroe County,54063,2000,14583,13514,14511,72
2020, West Virginia,Monroe County,54063,2020,12376,11771,12282,94
2020, West Virginia,Lewis County,54041,2020,17033,16162,16842,191
2000, West Virginia,Grant County,54023,2000,11299,11110,11237,62
2010, West Virginia,Grant County,54023,2010,11937,11657,11817,120
2010, West Virginia,Hampshire County,54027,2010,23964,23301,23722,242
2020, West Virginia,Hampshire County,54027,2020,23093,21775,22756,337
2010, West Virginia,Mason County,54053,2010,27324,26704,27205,119
2010, West Virginia,Hancock County,54029,2010,30676,29365,30362,314
2000, West Virginia,Summers County,54089,2000,12999,12553,12928,71
2020, West Virginia,Kanawha County,54039,2020,180745,153637,178025,2720
2000, West Virginia,Hampshire County,54027,2000,20203,19807,20091,112
2000, West Virginia,Marion County,54049,2000,56598,53823,56204,394
2020, West Virginia,Ohio County,54069,2020,42425,37769,41778,647
2010, West Virginia,Ohio County,54069,2010,44443,41416,44081,362
2000, West Virginia,Ohio County,54069,2000,47427,44820,47189,238
2020, West Virginia,Marion County,54049,2020,56205,50578,55330,875
2000, West Virginia,Upshur County,54097,2000,23404,22981,23267,137
2020, West Virginia,Upshur County,54097,2020,23816,22474,23500,316
2020, West Virginia,Jefferson County,54037,2020,57701,46825,53564,4137
2000, West Virginia,Jefferson County,54037,2000,42190,38400,41456,734
2000, West Virginia,Wayne County,54099,2000,42903,42382,42701,202
2020, West Virginia,Summers County,54089,2020,11959,10930,11774,185
2020, West Virginia,Wayne County,54099,2020,38982,37339,38663,319
2010, West Virginia,Upshur County,54097,2010,24254,23675,24004,250
2010, West Virginia,Marion County,54049,2010,56418,53226,55904,514
2010, West Virginia,Tyler County,54095,2010,9208,9112,9159,49
2020, West Virginia,Tyler County,54095,2020,8313,7981,8260,53
2000, West Virginia,Tyler County,54095,2000,9592,9530,9551,41
2010, West Virginia,Wayne County,54099,2010,42481,41870,42263,218
2010, West Virginia,Fayette County,54019,2010,46039,43026,45637,402
2010, West Virginia,Webster County,54101,2010,9154,9027,9106,48
2020, West Virginia,Fayette County,54019,2020,40488,36483,39963,525
2000, West Virginia,Fayette County,54019,2000,47579,44125,47254,325
2020, West Virginia,Jackson County,54035,2020,27791,26516,27561,230
2000, West Virginia,Jackson County,54035,2000,28000,27649,27919,81
2010, West Virginia,Jackson County,54035,2010,29211,28673,29026,185
2010, West Virginia,Jefferson County,54037,2010,53498,46876,51009,2489
2010, West Virginia,Summers County,54089,2010,13927,12957,13738,189
2020, West Virginia,Lincoln County,54043,2020,20463,19793,20292,171
2000, West Virginia,Kanawha County,54039,2000,200073,180989,198901,1172
2020, West Virginia,Hancock County,54029,2020,29095,26661,28671,424
2000, West Virginia,Hancock County,54029,2000,32667,31497,32424,243
2010, West Virginia,Hardy County,54031,2010,14025,13161,13547,478
2020, West Virginia,Hardy County,54031,2020,14299,12835,13640,659
2000, West Virginia,Hardy County,54031,2000,12669,12273,12585,84
2000, West Virginia,Harrison County,54033,2000,68652,66282,67992,660
2010, West Virginia,Harrison County,54033,2010,69099,66306,68216,883
2010, West Virginia,Kanawha County,54039,2010,193063,172036,191251,1812
2000, West Virginia,Mason County,54053,2000,25957,25533,25836,121
2020, West Virginia,Harrison County,54033,2020,65921,60334,64518,1403
2020, West Virginia,Marshall County,54051,2020,30591,28797,30237,354
2010, West Virginia,Marshall County,54051,2010,33107,32429,32842,265
2000, West Virginia,Marshall County,54051,2000,35519,34949,35291,228
2020, Wisconsin,Sheboygan County,55117,2020,118034,98204,109372,8662
2020, Wisconsin,Portage County,55097,2020,70377,62967,67757,2620
2000, Wisconsin,Portage County,55097,2000,67182,64316,66215,967
2010, Wisconsin,Portage County,55097,2010,70019,65981,68166,1853
2010, Wisconsin,Richland County,55103,2010,18021,17540,17661,360
2000, Wisconsin,Shawano County,55115,2000,40664,37251,40257,407
2000, Wisconsin,Lincoln County,55069,2000,29641,28977,29398,243
2020, Wisconsin,Florence County,55037,2020,4558,4312,4492,66
2020, Wisconsin,Lincoln County,55069,2020,28415,26909,27886,529
2010, Wisconsin,Lincoln County,55069,2010,28743,27929,28403,340
2010, Wisconsin,Trempealeau County,55121,2010,28816,27230,27149,1667
2010, Wisconsin,Florence County,55037,2010,4423,4306,4386,37
2000, Wisconsin,Sheboygan County,55117,2000,112646,104438,108857,3789
2000, Wisconsin,Florence County,55037,2000,5088,4995,5065,23
2010, Wisconsin,Fond du Lac County,55039,2010,101633,95674,97265,4368
2020, Wisconsin,Forest County,55041,2020,9179,7407,9024,155
2020, Wisconsin,Trempealeau County,55121,2020,30760,26301,26803,3957
2000, Wisconsin,Trempealeau County,55121,2000,27010,26688,26770,240
2020, Wisconsin,Richland County,55103,2020,17304,16157,16778,526
2000, Wisconsin,Forest County,55041,2000,10024,8607,9916,108
2010, Wisconsin,Forest County,55041,2010,9304,7690,9166,138
2000, Wisconsin,Wood County,55141,2000,75555,72855,74846,709
2020, Wisconsin,Wood County,55141,2020,74207,67814,71831,2376
2000, Wisconsin,Richland County,55103,2000,17924,17636,17757,167
2020, Wisconsin,Fond du Lac County,55039,2020,104154,91630,97437,6717
2010, Wisconsin,Wood County,55141,2010,74749,71048,73069,1680
2000, Wisconsin,Fond du Lac County,55039,2000,97296,93562,95309,1987
2010, Wisconsin,Sheboygan County,55117,2010,115507,103861,109178,6329
2010, Wisconsin,Shawano County,55115,2010,41949,37254,41044,905
2020, Wisconsin,Shawano County,55115,2020,40881,34679,39705,1176
2020, Wisconsin,Grant County,55043,2020,51938,48710,50702,1236
2020, Wisconsin,Price County,55099,2020,14054,13236,13874,180
2000, Wisconsin,La Crosse County,55063,2000,107120,100883,106130,990
2020, Wisconsin,St. Croix County,55109,2020,93536,86227,90857,2679
2010, Wisconsin,St. Croix County,55109,2010,84345,80914,82653,1692
2000, Wisconsin,St. Croix County,55109,2000,63155,61796,62672,483
2020, Wisconsin,Kewaunee County,55061,2020,20563,19149,19729,834
2000, Wisconsin,Kewaunee County,55061,2000,20187,19897,20034,153
2010, Wisconsin,Kewaunee County,55061,2010,20574,19955,20111,463
2010, Wisconsin,Kenosha County,55059,2010,166426,139416,146834,19592
2000, Wisconsin,Kenosha County,55059,2000,149577,132193,138820,10757
2020, Wisconsin,Kenosha County,55059,2020,169151,128417,144605,24546
2020, Wisconsin,Juneau County,55057,2020,26718,24299,25991,727
2000, Wisconsin,Juneau County,55057,2000,24316,23491,23969,347
2010, Wisconsin,Juneau County,55057,2010,26664,25077,25977,687
2010, Wisconsin,La Crosse County,55063,2010,114638,105540,112897,1741
2000, Wisconsin,Jefferson County,55055,2000,74021,71309,70990,3031
2020, Wisconsin,Jefferson County,55055,2020,84900,75145,77832,7068
2010, Wisconsin,Adams County,55001,2010,20875,19409,20092,783
2000, Wisconsin,Adams County,55001,2000,18643,18201,18375,268
2020, Wisconsin,Adams County,55001,2020,20654,18734,19857,797
2010, Wisconsin,Iowa County,55049,2010,23687,23127,23351,336
2000, Wisconsin,Iowa County,55049,2000,22780,22484,22705,75
2020, Wisconsin,Iowa County,55049,2020,23709,22326,23254,455
2000, Wisconsin,Jackson County,55053,2000,19100,17109,18743,357
2010, Wisconsin,Jackson County,55053,2010,20449,18258,19930,519
2020, Wisconsin,Jackson County,55053,2020,21145,18142,20467,678
2020, Wisconsin,Iron County,55051,2020,6137,5831,6065,72
2000, Wisconsin,Iron County,55051,2000,6861,6743,6816,45
2010, Wisconsin,Iron County,55051,2010,5916,5790,5881,35
2010, Wisconsin,Jefferson County,55055,2010,83686,78632,78131,5555
2020, Wisconsin,La Crosse County,55063,2020,120784,106317,117733,3051
2010, Wisconsin,Lafayette County,55065,2010,16836,16292,16314,522
2020, Wisconsin,Racine County,55101,2020,197727,142438,169816,27911
2000, Wisconsin,Price County,55099,2000,15822,15541,15706,116
2020, Wisconsin,Bayfield County,55007,2020,16220,13493,15941,279
2000, Wisconsin,Bayfield County,55007,2000,15013,13280,14922,91
2010, Wisconsin,Bayfield County,55007,2010,15014,13024,14856,158
2010, Wisconsin,Barron County,55005,2010,45870,44076,45008,862
2020, Wisconsin,Barron County,55005,2020,46711,42567,45434,1277
2000, Wisconsin,Barron County,55005,2000,44963,43924,44533,430
2010, Wisconsin,Manitowoc County,55071,2010,81442,76402,78877,2565
2000, Wisconsin,Grant County,55043,2000,49597,48719,49317,280
2010, Wisconsin,Grant County,55043,2010,51208,49655,50559,649
2000, Wisconsin,Green County,55045,2000,33647,33021,33320,327
2020, Wisconsin,Green County,55045,2020,37093,34318,35593,1500
2010, Wisconsin,Green County,55045,2010,36842,35593,35809,1033
2020, Wisconsin,Green Lake County,55047,2020,19018,17505,18039,979
2000, Wisconsin,Green Lake County,55047,2000,19105,18687,18712,393
2010, Wisconsin,Green Lake County,55047,2010,19051,18428,18308,743
2020, Wisconsin,Langlade County,55067,2020,19491,18125,19032,459
2000, Wisconsin,Langlade County,55067,2000,20740,20311,20569,171
2010, Wisconsin,Langlade County,55067,2010,19977,19267,19653,324
2020, Wisconsin,Taylor County,55119,2020,19913,18878,19346,567
2010, Wisconsin,Taylor County,55119,2010,20689,20248,20373,316
2000, Wisconsin,Taylor County,55119,2000,19680,19427,19553,127
2000, Wisconsin,Racine County,55101,2000,188831,156796,173841,14990
2000, Wisconsin,Lafayette County,55065,2000,16137,15980,16045,92
2020, Wisconsin,Lafayette County,55065,2020,16611,15231,15522,1089
2000, Wisconsin,Ashland County,55003,2000,16866,14690,16678,188
2020, Wisconsin,Ashland County,55003,2020,16027,12791,15644,383
2010, Wisconsin,Ashland County,55003,2010,16157,13662,15855,302
2010, Wisconsin,Racine County,55101,2010,195408,155731,172862,22546
2010, Wisconsin,Price County,55099,2010,14159,13750,14006,153
2000, Wisconsin,Manitowoc County,55071,2000,82887,79485,81544,1343
2010, Wisconsin,Winnebago County,55139,2010,166994,154445,161210,5784
2010, Wisconsin,Marathon County,55073,2010,134063,122446,131071,2992
2010, Wisconsin,Clark County,55019,2010,34690,33338,33398,1292
2020, Wisconsin,Burnett County,55013,2020,16526,14756,16272,254
2000, Wisconsin,Burnett County,55013,2000,15674,14616,15554,120
2010, Wisconsin,Burnett County,55013,2010,15457,14163,15263,194
2000, Wisconsin,Buffalo County,55011,2000,13804,13623,13719,85
2020, Wisconsin,Buffalo County,55011,2020,13317,12651,12990,327
2010, Wisconsin,Buffalo County,55011,2010,13587,13253,13350,237
2020, Wisconsin,Columbia County,55021,2020,58490,53739,56351,2139
2000, Wisconsin,Columbia County,55021,2000,52468,50990,51641,827
2010, Wisconsin,Columbia County,55021,2010,56833,54468,55389,1444
2020, Wisconsin,Washburn County,55129,2020,16623,15442,16324,299
2010, Wisconsin,Washburn County,55129,2010,15911,15343,15703,208
2000, Wisconsin,Washburn County,55129,2000,16036,15599,15893,143
2020, Wisconsin,Manitowoc County,55071,2020,81359,72034,77309,4050
2020, Wisconsin,Clark County,55019,2020,34659,31972,32561,2098
2020, Wisconsin,Crawford County,55023,2020,16113,15107,15853,260
2000, Wisconsin,Brown County,55009,2000,226778,206688,218080,8698
2000, Wisconsin,Crawford County,55023,2000,17243,16780,17114,129
2020, Wisconsin,Brown County,55009,2020,268740,212929,242524,26216
2010, Wisconsin,Brown County,55009,2010,248007,214415,230022,17985
2010, Wisconsin,Monroe County,55081,2010,44673,41940,43012,1661
2000, Wisconsin,Monroe County,55081,2000,40899,39474,40159,740
2020, Wisconsin,Walworth County,55127,2020,106478,90957,93928,12550
2000, Wisconsin,Walworth County,55127,2000,93759,88597,87623,6136
2010, Wisconsin,Walworth County,55127,2010,102228,93935,91650,10578
2020, Wisconsin,Monroe County,55081,2020,46274,41293,43714,2560
2000, Wisconsin,Pepin County,55091,2000,7213,7134,7188,25
2010, Wisconsin,Pepin County,55091,2010,7469,7337,7397,72
2020, Wisconsin,Pepin County,55091,2020,7318,6899,7161,157
2020, Wisconsin,Rock County,55105,2020,163687,133107,147887,15800
2010, Wisconsin,Crawford County,55023,2010,16644,16080,16494,150
2000, Wisconsin,Clark County,55019,2000,33557,32904,33153,404
2000, Wisconsin,Chippewa County,55017,2000,55195,54006,54906,289
2010, Wisconsin,Washington County,55131,2010,131887,126317,128502,3385
2010, Wisconsin,Oneida County,55085,2010,35998,34787,35613,385
2000, Wisconsin,Oneida County,55085,2000,36776,35934,36532,244
2020, Wisconsin,Oneida County,55085,2020,37845,35468,37270,575
2000, Wisconsin,Outagamie County,55087,2000,160971,151101,157764,3207
2020, Wisconsin,Calumet County,55015,2020,52442,46499,49585,2857
2000, Wisconsin,Calumet County,55015,2000,40631,39282,40196,435
2010, Wisconsin,Calumet County,55015,2010,48971,46187,47281,1690
2020, Wisconsin,Outagamie County,55087,2020,190705,164009,181282,9423
2010, Wisconsin,Outagamie County,55087,2010,176695,161238,170336,6359
2020, Wisconsin,Ozaukee County,55089,2020,91503,82306,88405,3098
2000, Wisconsin,Rusk County,55107,2000,15347,14992,15231,116
2010, Wisconsin,Ozaukee County,55089,2010,86395,82010,84439,1956
2000, Wisconsin,Ozaukee County,55089,2000,82317,79621,81244,1073
2020, Wisconsin,Rusk County,55107,2020,14188,13371,13938,250
2010, Wisconsin,Rusk County,55107,2010,14755,14398,14582,173
2000, Wisconsin,Oconto County,55083,2000,35634,34836,35394,240
2010, Wisconsin,Oconto County,55083,2010,37660,36418,37141,519
2000, Wisconsin,Washington County,55131,2000,117493,114778,115964,1529
2020, Wisconsin,Washington County,55131,2020,136761,125351,131934,4827
2010, Wisconsin,Chippewa County,55017,2010,62415,59504,61615,800
2020, Wisconsin,Chippewa County,55017,2020,66297,60865,65040,1257
2000, Wisconsin,Waukesha County,55133,2000,360767,345506,351264,9503
2010, Wisconsin,Waukesha County,55133,2010,389891,363963,373768,16123
2000, Wisconsin,Dane County,55025,2000,426526,379447,412139,14387
2020, Wisconsin,Waukesha County,55133,2020,406978,353946,385143,21835
2000, Wisconsin,Waupaca County,55135,2000,51731,50660,51017,714
2020, Wisconsin,Waupaca County,55135,2020,51812,48284,49948,1864
2000, Wisconsin,Waushara County,55137,2000,23154,22413,22306,848
2010, Wisconsin,Waushara County,55137,2010,24496,23012,23167,1329
2020, Wisconsin,Waushara County,55137,2020,24520,22048,22827,1693
2020, Wisconsin,Oconto County,55083,2020,38965,36432,38117,848
2010, Wisconsin,Waupaca County,55135,2010,52410,50916,51103,1307
2020, Wisconsin,Dane County,55025,2020,561504,435458,519550,41954
2010, Wisconsin,Dane County,55025,2010,488073,413631,459148,28925
2010, Wisconsin,Rock County,55105,2010,160331,140513,148207,12124
2000, Wisconsin,Douglas County,55031,2000,43287,41273,42972,315
2010, Wisconsin,Douglas County,55031,2010,44159,41166,43665,494
2020, Wisconsin,Douglas County,55031,2020,44295,39733,43527,768
2020, Wisconsin,Door County,55029,2020,30066,27754,28928,1138
2010, Wisconsin,Door County,55029,2010,27785,26839,27114,671
2000, Wisconsin,Pierce County,55093,2000,36804,36071,36503,301
2000, Wisconsin,Rock County,55105,2000,152307,138610,146354,5953
2010, Wisconsin,Pierce County,55093,2010,41019,39614,40396,623
2000, Wisconsin,Door County,55029,2000,27961,27356,27694,267
2020, Wisconsin,Dodge County,55027,2020,89396,79395,83906,5490
2000, Wisconsin,Dodge County,55027,2000,85897,81843,83709,2188
2010, Wisconsin,Dodge County,55027,2010,88759,83294,85237,3522
2000, Wisconsin,Vernon County,55123,2000,28056,27723,27870,186
2020, Wisconsin,Vernon County,55123,2020,30714,29315,30250,464
2010, Wisconsin,Vernon County,55123,2010,29773,29085,29379,394
2010, Wisconsin,Dunn County,55033,2010,43857,41545,43231,626
2010, Wisconsin,Vilas County,55125,2010,21430,18658,21162,268
2000, Wisconsin,Dunn County,55033,2000,39858,38294,39523,335
2010, Wisconsin,Eau Claire County,55035,2010,98736,91946,96932,1804
2010, Wisconsin,Polk County,55095,2010,44205,42807,43549,656
2000, Wisconsin,Winnebago County,55139,2000,156763,148795,153698,3065
2020, Wisconsin,Winnebago County,55139,2020,171730,148041,163402,8328
2000, Wisconsin,Polk County,55095,2000,41319,40342,40990,329
2020, Wisconsin,Polk County,55095,2020,44977,42075,44030,947
2020, Wisconsin,Marathon County,55073,2020,138013,119902,133560,4453
2000, Wisconsin,Marathon County,55073,2000,125834,118079,124855,979
2020, Wisconsin,Marinette County,55075,2020,41872,39100,40793,1079
2010, Wisconsin,Marinette County,55075,2010,41749,40559,41227,522
2000, Wisconsin,Marinette County,55075,2000,43384,42550,43059,325
2020, Wisconsin,Marquette County,55077,2020,15592,14688,15104,488
2000, Wisconsin,Marquette County,55077,2000,15832,14828,15411,421
2010, Wisconsin,Marquette County,55077,2010,15404,14920,15013,391
2020, Wisconsin,Eau Claire County,55035,2020,105710,93277,102592,3118
2000, Wisconsin,Eau Claire County,55035,2000,93142,88443,92263,879
2020, Wisconsin,Dunn County,55033,2020,45440,41198,44405,1035
2020, Wisconsin,Vilas County,55125,2020,23047,19701,22588,459
2020, Wisconsin,Pierce County,55093,2020,42212,38964,40992,1220
2020, Wisconsin,Sauk County,55111,2020,65763,58602,61713,4050
2010, Wisconsin,Menominee County,55078,2010,4232,451,4054,178
2010, Wisconsin,Sauk County,55111,2010,61976,58588,59301,2675
2000, Wisconsin,Sauk County,55111,2000,55225,53775,54287,938
2010, Wisconsin,Sawyer County,55113,2010,16557,13123,16289,268
2000, Wisconsin,Sawyer County,55113,2000,16196,13236,16051,145
2020, Wisconsin,Sawyer County,55113,2020,18074,13920,17716,358
2000, Wisconsin,Menominee County,55078,2000,4562,528,4440,122
2000, Wisconsin,Vilas County,55125,2000,21033,18865,20852,181
2020, Wisconsin,Menominee County,55078,2020,4255,500,4119,136
2020, Wisconsin,Milwaukee County,55079,2020,939489,488198,786472,153017
2000, Wisconsin,Milwaukee County,55079,2000,940164,616973,857758,82406
2010, Wisconsin,Milwaukee County,55079,2010,947735,574656,821696,126039
2010, Wyoming,Big Horn County,56003,2010,11668,11009,10684,984
2020, Wyoming,Campbell County,56005,2020,47026,40762,42743,4283
2010, Wyoming,Campbell County,56005,2010,46133,42974,42522,3611
2020, Wyoming,Johnson County,56019,2020,8447,7771,8100,347
2000, Wyoming,Campbell County,56005,2000,33698,32369,32507,1191
2000, Wyoming,Johnson County,56019,2000,7075,6865,6927,148
2010, Wyoming,Johnson County,56019,2010,8569,8267,8293,276
2020, Wyoming,Hot Springs County,56017,2020,4621,4219,4444,177
2020, Wyoming,Carbon County,56007,2020,14537,11957,11937,2600
2010, Wyoming,Carbon County,56007,2010,15885,14103,13217,2668
2000, Wyoming,Hot Springs County,56017,2000,4882,4685,4766,116
2010, Wyoming,Hot Springs County,56017,2010,4812,4609,4707,105
2000, Wyoming,Carbon County,56007,2000,15639,14092,13476,2163
2020, Wyoming,Albany County,56001,2020,37066,30918,33156,3910
2000, Wyoming,Albany County,56001,2000,32014,29235,29617,2397
2020, Wyoming,Sublette County,56035,2020,8728,7786,8092,636
2010, Wyoming,Sublette County,56035,2010,10247,9552,9535,712
2000, Wyoming,Sublette County,56035,2000,5920,5771,5808,112
2000, Wyoming,Sheridan County,56033,2000,26560,25465,25914,646
2020, Wyoming,Goshen County,56015,2020,12498,11113,11286,1212
2000, Wyoming,Goshen County,56015,2000,12538,11764,11431,1107
2010, Wyoming,Goshen County,56015,2010,13249,12526,11961,1288
2010, Wyoming,Albany County,56001,2010,36299,32720,33097,3202
2010, Wyoming,Uinta County,56041,2010,21118,19514,19263,1855
2020, Wyoming,Uinta County,56041,2020,20450,18007,18464,1986
2000, Wyoming,Uinta County,56041,2000,19742,18621,18687,1055
2020, Wyoming,Big Horn County,56003,2020,11521,10271,10452,1069
2010, Wyoming,Sheridan County,56033,2010,29116,27782,28103,1013
2000, Wyoming,Big Horn County,56003,2000,11461,10777,10754,707
2020, Wyoming,Sheridan County,56033,2020,30921,28000,29505,1416
2000, Wyoming,Washakie County,56043,2000,8289,7478,7338,951
2020, Wyoming,Weston County,56045,2020,6838,6197,6543,295
2010, Wyoming,Laramie County,56021,2010,91738,81205,79760,11978
2020, Wyoming,Niobrara County,56027,2020,2467,2288,2391,76
2020, Wyoming,Park County,56029,2020,29624,26872,27927,1697
2010, Wyoming,Park County,56029,2010,28205,26951,26840,1365
2000, Wyoming,Park County,56029,2000,25786,24872,24827,959
2000, Wyoming,Laramie County,56021,2000,81607,72563,72710,8897
2000, Wyoming,Converse County,56009,2000,12052,11416,11392,660
2010, Wyoming,Converse County,56009,2010,13833,13160,12966,867
2020, Wyoming,Natrona County,56025,2020,79955,69319,72786,7169
2000, Wyoming,Natrona County,56025,2000,66533,62644,63276,3257
2010, Wyoming,Natrona County,56025,2010,75450,70015,70219,5231
2010, Wyoming,Washakie County,56043,2010,8533,7795,7371,1162
2020, Wyoming,Fremont County,56013,2020,39234,27238,36813,2421
2010, Wyoming,Fremont County,56013,2010,40123,29813,37859,2264
2000, Wyoming,Fremont County,56013,2000,35804,27388,34238,1566
2000, Wyoming,Teton County,56039,2000,18251,17081,17066,1185
2020, Wyoming,Teton County,56039,2020,23331,19202,20036,3295
2010, Wyoming,Niobrara County,56027,2010,2484,2397,2432,52
2000, Wyoming,Niobrara County,56027,2000,2407,2360,2371,36
2000, Wyoming,Weston County,56045,2000,6644,6374,6507,137
2020, Wyoming,Washakie County,56043,2020,7685,6600,6615,1070
2000, Wyoming,Platte County,56031,2000,8807,8471,8342,465
2020, Wyoming,Crook County,56011,2020,7181,6792,7069,112
2010, Wyoming,Platte County,56031,2010,8667,8268,8087,580
2020, Wyoming,Platte County,56031,2020,8605,7738,7910,695
2010, Wyoming,Crook County,56011,2010,7083,6884,6942,141
2010, Wyoming,Weston County,56045,2010,7208,6885,6992,216
2000, Wyoming,Crook County,56011,2000,5887,5761,5833,54
2000, Wyoming,Lincoln County,56023,2000,14573,14157,14258,315
2020, Wyoming,Lincoln County,56023,2020,19581,17971,18622,959
2000, Wyoming,Sweetwater County,56037,2000,37613,34461,34068,3545
2010, Wyoming,Sweetwater County,56037,2010,43806,38748,37117,6689
2020, Wyoming,Sweetwater County,56037,2020,42272,34389,35315,6957
2020, Wyoming,Laramie County,56021,2020,100512,80598,84910,15602
2010, Wyoming,Teton County,56039,2010,21294,18821,18103,3191
2010, Wyoming,Lincoln County,56023,2010,18106,17281,17325,781
2020, Wyoming,Converse County,56009,2020,13751,12366,12689,1062
